player_Guillermo-Jara_Club	player_Guillermo-Jara	player_Club
player_Guillermo-Jara_POS	player_Guillermo-Jara	player_POS
player_Guillermo-Jara_GP	player_Guillermo-Jara	player_GP
player_Guillermo-Jara_GS	player_Guillermo-Jara	player_GS
player_Guillermo-Jara_A	player_Guillermo-Jara	player_A
player_Guillermo-Jara_GWA	player_Guillermo-Jara	player_GWA
player_Guillermo-Jara_HmA	player_Guillermo-Jara	player_HmA
player_Guillermo-Jara_RdA	player_Guillermo-Jara	player_RdA
player_Guillermo-Jara_A.90min	player_Guillermo-Jara	player_A.90min
player_Eric-Wynalda_Club	player_Eric-Wynalda	player_Club
player_Eric-Wynalda_POS	player_Eric-Wynalda	player_POS
player_Eric-Wynalda_GP	player_Eric-Wynalda	player_GP
player_Eric-Wynalda_GS	player_Eric-Wynalda	player_GS
player_Eric-Wynalda_A	player_Eric-Wynalda	player_A
player_Eric-Wynalda_GWA	player_Eric-Wynalda	player_GWA
player_Eric-Wynalda_HmA	player_Eric-Wynalda	player_HmA
player_Eric-Wynalda_RdA	player_Eric-Wynalda	player_RdA
player_Eric-Wynalda_A.90min	player_Eric-Wynalda	player_A.90min
player_Christopher-Sullivan_Club	player_Christopher-Sullivan	player_Club
player_Christopher-Sullivan_POS	player_Christopher-Sullivan	player_POS
player_Christopher-Sullivan_GP	player_Christopher-Sullivan	player_GP
player_Christopher-Sullivan_GS	player_Christopher-Sullivan	player_GS
player_Christopher-Sullivan_A	player_Christopher-Sullivan	player_A
player_Christopher-Sullivan_GWA	player_Christopher-Sullivan	player_GWA
player_Christopher-Sullivan_HmA	player_Christopher-Sullivan	player_HmA
player_Christopher-Sullivan_RdA	player_Christopher-Sullivan	player_RdA
player_Christopher-Sullivan_A.90min	player_Christopher-Sullivan	player_A.90min
player_Ross-Paule_Club	player_Ross-Paule	player_Club
player_Ross-Paule_POS	player_Ross-Paule	player_POS
player_Ross-Paule_GP	player_Ross-Paule	player_GP
player_Ross-Paule_GS	player_Ross-Paule	player_GS
player_Ross-Paule_A	player_Ross-Paule	player_A
player_Ross-Paule_GWA	player_Ross-Paule	player_GWA
player_Ross-Paule_HmA	player_Ross-Paule	player_HmA
player_Ross-Paule_RdA	player_Ross-Paule	player_RdA
player_Ross-Paule_A.90min	player_Ross-Paule	player_A.90min
player_Welton_Club	player_Welton	player_Club
player_Welton_POS	player_Welton	player_POS
player_Welton_GP	player_Welton	player_GP
player_Welton_GS	player_Welton	player_GS
player_Welton_A	player_Welton	player_A
player_Welton_GWA	player_Welton	player_GWA
player_Welton_HmA	player_Welton	player_HmA
player_Welton_RdA	player_Welton	player_RdA
player_Welton_A.90min	player_Welton	player_A.90min
player_Francisco-Uribe_Club	player_Francisco-Uribe	player_Club
player_Francisco-Uribe_POS	player_Francisco-Uribe	player_POS
player_Francisco-Uribe_GP	player_Francisco-Uribe	player_GP
player_Francisco-Uribe_GS	player_Francisco-Uribe	player_GS
player_Francisco-Uribe_A	player_Francisco-Uribe	player_A
player_Francisco-Uribe_GWA	player_Francisco-Uribe	player_GWA
player_Francisco-Uribe_HmA	player_Francisco-Uribe	player_HmA
player_Francisco-Uribe_RdA	player_Francisco-Uribe	player_RdA
player_Francisco-Uribe_A.90min	player_Francisco-Uribe	player_A.90min
player_Wellington-Sanchez_Club	player_Wellington-Sanchez	player_Club
player_Wellington-Sanchez_POS	player_Wellington-Sanchez	player_POS
player_Wellington-Sanchez_GP	player_Wellington-Sanchez	player_GP
player_Wellington-Sanchez_GS	player_Wellington-Sanchez	player_GS
player_Wellington-Sanchez_A	player_Wellington-Sanchez	player_A
player_Wellington-Sanchez_GWA	player_Wellington-Sanchez	player_GWA
player_Wellington-Sanchez_HmA	player_Wellington-Sanchez	player_HmA
player_Wellington-Sanchez_RdA	player_Wellington-Sanchez	player_RdA
player_Wellington-Sanchez_A.90min	player_Wellington-Sanchez	player_A.90min
player_Joe-Franchino_Club	player_Joe-Franchino	player_Club
player_Joe-Franchino_POS	player_Joe-Franchino	player_POS
player_Joe-Franchino_GP	player_Joe-Franchino	player_GP
player_Joe-Franchino_GS	player_Joe-Franchino	player_GS
player_Joe-Franchino_A	player_Joe-Franchino	player_A
player_Joe-Franchino_GWA	player_Joe-Franchino	player_GWA
player_Joe-Franchino_HmA	player_Joe-Franchino	player_HmA
player_Joe-Franchino_RdA	player_Joe-Franchino	player_RdA
player_Joe-Franchino_A.90min	player_Joe-Franchino	player_A.90min
player_Wolde-Harris_Club	player_Wolde-Harris	player_Club
player_Wolde-Harris_POS	player_Wolde-Harris	player_POS
player_Wolde-Harris_GP	player_Wolde-Harris	player_GP
player_Wolde-Harris_GS	player_Wolde-Harris	player_GS
player_Wolde-Harris_A	player_Wolde-Harris	player_A
player_Wolde-Harris_GWA	player_Wolde-Harris	player_GWA
player_Wolde-Harris_HmA	player_Wolde-Harris	player_HmA
player_Wolde-Harris_RdA	player_Wolde-Harris	player_RdA
player_Wolde-Harris_A.90min	player_Wolde-Harris	player_A.90min
player_Brian-Sebapole_Club	player_Brian-Sebapole	player_Club
player_Brian-Sebapole_POS	player_Brian-Sebapole	player_POS
player_Brian-Sebapole_GP	player_Brian-Sebapole	player_GP
player_Brian-Sebapole_GS	player_Brian-Sebapole	player_GS
player_Brian-Sebapole_A	player_Brian-Sebapole	player_A
player_Brian-Sebapole_GWA	player_Brian-Sebapole	player_GWA
player_Brian-Sebapole_HmA	player_Brian-Sebapole	player_HmA
player_Brian-Sebapole_RdA	player_Brian-Sebapole	player_RdA
player_Brian-Sebapole_A.90min	player_Brian-Sebapole	player_A.90min
player_Marquinho_Club	player_Marquinho	player_Club
player_Marquinho_POS	player_Marquinho	player_POS
player_Marquinho_GP	player_Marquinho	player_GP
player_Marquinho_GS	player_Marquinho	player_GS
player_Marquinho_A	player_Marquinho	player_A
player_Marquinho_GWA	player_Marquinho	player_GWA
player_Marquinho_HmA	player_Marquinho	player_HmA
player_Marquinho_RdA	player_Marquinho	player_RdA
player_Marquinho_A.90min	player_Marquinho	player_A.90min
player_Jason-Boyce_Club	player_Jason-Boyce	player_Club
player_Jason-Boyce_POS	player_Jason-Boyce	player_POS
player_Jason-Boyce_GP	player_Jason-Boyce	player_GP
player_Jason-Boyce_GS	player_Jason-Boyce	player_GS
player_Jason-Boyce_A	player_Jason-Boyce	player_A
player_Jason-Boyce_GWA	player_Jason-Boyce	player_GWA
player_Jason-Boyce_HmA	player_Jason-Boyce	player_HmA
player_Jason-Boyce_RdA	player_Jason-Boyce	player_RdA
player_Jason-Boyce_A.90min	player_Jason-Boyce	player_A.90min
player_Shawn-Medved_Club	player_Shawn-Medved	player_Club
player_Shawn-Medved_POS	player_Shawn-Medved	player_POS
player_Shawn-Medved_GP	player_Shawn-Medved	player_GP
player_Shawn-Medved_GS	player_Shawn-Medved	player_GS
player_Shawn-Medved_A	player_Shawn-Medved	player_A
player_Shawn-Medved_GWA	player_Shawn-Medved	player_GWA
player_Shawn-Medved_HmA	player_Shawn-Medved	player_HmA
player_Shawn-Medved_RdA	player_Shawn-Medved	player_RdA
player_Shawn-Medved_A.90min	player_Shawn-Medved	player_A.90min
player_Scott-Bower_Club	player_Scott-Bower	player_Club
player_Scott-Bower_POS	player_Scott-Bower	player_POS
player_Scott-Bower_GP	player_Scott-Bower	player_GP
player_Scott-Bower_GS	player_Scott-Bower	player_GS
player_Scott-Bower_A	player_Scott-Bower	player_A
player_Scott-Bower_GWA	player_Scott-Bower	player_GWA
player_Scott-Bower_HmA	player_Scott-Bower	player_HmA
player_Scott-Bower_RdA	player_Scott-Bower	player_RdA
player_Scott-Bower_A.90min	player_Scott-Bower	player_A.90min
player_Anders-Limpar_Club	player_Anders-Limpar	player_Club
player_Anders-Limpar_POS	player_Anders-Limpar	player_POS
player_Anders-Limpar_GP	player_Anders-Limpar	player_GP
player_Anders-Limpar_GS	player_Anders-Limpar	player_GS
player_Anders-Limpar_A	player_Anders-Limpar	player_A
player_Anders-Limpar_GWA	player_Anders-Limpar	player_GWA
player_Anders-Limpar_HmA	player_Anders-Limpar	player_HmA
player_Anders-Limpar_RdA	player_Anders-Limpar	player_RdA
player_Anders-Limpar_A.90min	player_Anders-Limpar	player_A.90min
player_Matt-Okoh_Club	player_Matt-Okoh	player_Club
player_Matt-Okoh_POS	player_Matt-Okoh	player_POS
player_Matt-Okoh_GP	player_Matt-Okoh	player_GP
player_Matt-Okoh_GS	player_Matt-Okoh	player_GS
player_Matt-Okoh_A	player_Matt-Okoh	player_A
player_Matt-Okoh_GWA	player_Matt-Okoh	player_GWA
player_Matt-Okoh_HmA	player_Matt-Okoh	player_HmA
player_Matt-Okoh_RdA	player_Matt-Okoh	player_RdA
player_Matt-Okoh_A.90min	player_Matt-Okoh	player_A.90min
player_Joey-DiGiamarino_Club	player_Joey-DiGiamarino	player_Club
player_Joey-DiGiamarino_POS	player_Joey-DiGiamarino	player_POS
player_Joey-DiGiamarino_GP	player_Joey-DiGiamarino	player_GP
player_Joey-DiGiamarino_GS	player_Joey-DiGiamarino	player_GS
player_Joey-DiGiamarino_A	player_Joey-DiGiamarino	player_A
player_Joey-DiGiamarino_GWA	player_Joey-DiGiamarino	player_GWA
player_Joey-DiGiamarino_HmA	player_Joey-DiGiamarino	player_HmA
player_Joey-DiGiamarino_RdA	player_Joey-DiGiamarino	player_RdA
player_Joey-DiGiamarino_A.90min	player_Joey-DiGiamarino	player_A.90min
player_Raul-Diaz-Arce_Club	player_Raul-Diaz-Arce	player_Club
player_Raul-Diaz-Arce_POS	player_Raul-Diaz-Arce	player_POS
player_Raul-Diaz-Arce_GP	player_Raul-Diaz-Arce	player_GP
player_Raul-Diaz-Arce_GS	player_Raul-Diaz-Arce	player_GS
player_Raul-Diaz-Arce_A	player_Raul-Diaz-Arce	player_A
player_Raul-Diaz-Arce_GWA	player_Raul-Diaz-Arce	player_GWA
player_Raul-Diaz-Arce_HmA	player_Raul-Diaz-Arce	player_HmA
player_Raul-Diaz-Arce_RdA	player_Raul-Diaz-Arce	player_RdA
player_Raul-Diaz-Arce_A.90min	player_Raul-Diaz-Arce	player_A.90min
player_Dwayne-De-Rosario_Club	player_Dwayne-De-Rosario	player_Club
player_Dwayne-De-Rosario_POS	player_Dwayne-De-Rosario	player_POS
player_Dwayne-De-Rosario_GP	player_Dwayne-De-Rosario	player_GP
player_Dwayne-De-Rosario_GS	player_Dwayne-De-Rosario	player_GS
player_Dwayne-De-Rosario_A	player_Dwayne-De-Rosario	player_A
player_Dwayne-De-Rosario_GWA	player_Dwayne-De-Rosario	player_GWA
player_Dwayne-De-Rosario_HmA	player_Dwayne-De-Rosario	player_HmA
player_Dwayne-De-Rosario_RdA	player_Dwayne-De-Rosario	player_RdA
player_Dwayne-De-Rosario_A.90min	player_Dwayne-De-Rosario	player_A.90min
player_Chris-Carrieri_Club	player_Chris-Carrieri	player_Club
player_Chris-Carrieri_POS	player_Chris-Carrieri	player_POS
player_Chris-Carrieri_GP	player_Chris-Carrieri	player_GP
player_Chris-Carrieri_GS	player_Chris-Carrieri	player_GS
player_Chris-Carrieri_A	player_Chris-Carrieri	player_A
player_Chris-Carrieri_GWA	player_Chris-Carrieri	player_GWA
player_Chris-Carrieri_HmA	player_Chris-Carrieri	player_HmA
player_Chris-Carrieri_RdA	player_Chris-Carrieri	player_RdA
player_Chris-Carrieri_A.90min	player_Chris-Carrieri	player_A.90min
player_Junior-Agogo_Club	player_Junior-Agogo	player_Club
player_Junior-Agogo_POS	player_Junior-Agogo	player_POS
player_Junior-Agogo_GP	player_Junior-Agogo	player_GP
player_Junior-Agogo_GS	player_Junior-Agogo	player_GS
player_Junior-Agogo_A	player_Junior-Agogo	player_A
player_Junior-Agogo_GWA	player_Junior-Agogo	player_GWA
player_Junior-Agogo_HmA	player_Junior-Agogo	player_HmA
player_Junior-Agogo_RdA	player_Junior-Agogo	player_RdA
player_Junior-Agogo_A.90min	player_Junior-Agogo	player_A.90min
player_Luis-Hernandez_Club	player_Luis-Hernandez	player_Club
player_Luis-Hernandez_POS	player_Luis-Hernandez	player_POS
player_Luis-Hernandez_GP	player_Luis-Hernandez	player_GP
player_Luis-Hernandez_GS	player_Luis-Hernandez	player_GS
player_Luis-Hernandez_A	player_Luis-Hernandez	player_A
player_Luis-Hernandez_GWA	player_Luis-Hernandez	player_GWA
player_Luis-Hernandez_HmA	player_Luis-Hernandez	player_HmA
player_Luis-Hernandez_RdA	player_Luis-Hernandez	player_RdA
player_Luis-Hernandez_A.90min	player_Luis-Hernandez	player_A.90min
player_Raul-Palacios_Club	player_Raul-Palacios	player_Club
player_Raul-Palacios_POS	player_Raul-Palacios	player_POS
player_Raul-Palacios_GP	player_Raul-Palacios	player_GP
player_Raul-Palacios_GS	player_Raul-Palacios	player_GS
player_Raul-Palacios_A	player_Raul-Palacios	player_A
player_Raul-Palacios_GWA	player_Raul-Palacios	player_GWA
player_Raul-Palacios_HmA	player_Raul-Palacios	player_HmA
player_Raul-Palacios_RdA	player_Raul-Palacios	player_RdA
player_Raul-Palacios_A.90min	player_Raul-Palacios	player_A.90min
player_Gavin-Glinton_Club	player_Gavin-Glinton	player_Club
player_Gavin-Glinton_POS	player_Gavin-Glinton	player_POS
player_Gavin-Glinton_GP	player_Gavin-Glinton	player_GP
player_Gavin-Glinton_GS	player_Gavin-Glinton	player_GS
player_Gavin-Glinton_A	player_Gavin-Glinton	player_A
player_Gavin-Glinton_GWA	player_Gavin-Glinton	player_GWA
player_Gavin-Glinton_HmA	player_Gavin-Glinton	player_HmA
player_Gavin-Glinton_RdA	player_Gavin-Glinton	player_RdA
player_Gavin-Glinton_A.90min	player_Gavin-Glinton	player_A.90min
player_Alberto-Delgado_Club	player_Alberto-Delgado	player_Club
player_Alberto-Delgado_POS	player_Alberto-Delgado	player_POS
player_Alberto-Delgado_GP	player_Alberto-Delgado	player_GP
player_Alberto-Delgado_GS	player_Alberto-Delgado	player_GS
player_Alberto-Delgado_A	player_Alberto-Delgado	player_A
player_Alberto-Delgado_GWA	player_Alberto-Delgado	player_GWA
player_Alberto-Delgado_HmA	player_Alberto-Delgado	player_HmA
player_Alberto-Delgado_RdA	player_Alberto-Delgado	player_RdA
player_Alberto-Delgado_A.90min	player_Alberto-Delgado	player_A.90min
player_Ned-Grabavoy_Club	player_Ned-Grabavoy	player_Club
player_Ned-Grabavoy_POS	player_Ned-Grabavoy	player_POS
player_Ned-Grabavoy_GP	player_Ned-Grabavoy	player_GP
player_Ned-Grabavoy_GS	player_Ned-Grabavoy	player_GS
player_Ned-Grabavoy_A	player_Ned-Grabavoy	player_A
player_Ned-Grabavoy_GWA	player_Ned-Grabavoy	player_GWA
player_Ned-Grabavoy_HmA	player_Ned-Grabavoy	player_HmA
player_Ned-Grabavoy_RdA	player_Ned-Grabavoy	player_RdA
player_Ned-Grabavoy_A.90min	player_Ned-Grabavoy	player_A.90min
player_Brian-Ching_Club	player_Brian-Ching	player_Club
player_Brian-Ching_POS	player_Brian-Ching	player_POS
player_Brian-Ching_GP	player_Brian-Ching	player_GP
player_Brian-Ching_GS	player_Brian-Ching	player_GS
player_Brian-Ching_A	player_Brian-Ching	player_A
player_Brian-Ching_GWA	player_Brian-Ching	player_GWA
player_Brian-Ching_HmA	player_Brian-Ching	player_HmA
player_Brian-Ching_RdA	player_Brian-Ching	player_RdA
player_Brian-Ching_A.90min	player_Brian-Ching	player_A.90min
player_Ednaldo-da-Conceicao_Club	player_Ednaldo-da-Conceicao	player_Club
player_Ednaldo-da-Conceicao_POS	player_Ednaldo-da-Conceicao	player_POS
player_Ednaldo-da-Conceicao_GP	player_Ednaldo-da-Conceicao	player_GP
player_Ednaldo-da-Conceicao_GS	player_Ednaldo-da-Conceicao	player_GS
player_Ednaldo-da-Conceicao_A	player_Ednaldo-da-Conceicao	player_A
player_Ednaldo-da-Conceicao_GWA	player_Ednaldo-da-Conceicao	player_GWA
player_Ednaldo-da-Conceicao_HmA	player_Ednaldo-da-Conceicao	player_HmA
player_Ednaldo-da-Conceicao_RdA	player_Ednaldo-da-Conceicao	player_RdA
player_Ednaldo-da-Conceicao_A.90min	player_Ednaldo-da-Conceicao	player_A.90min
player_Josh-Gardner_Club	player_Josh-Gardner	player_Club
player_Josh-Gardner_POS	player_Josh-Gardner	player_POS
player_Josh-Gardner_GP	player_Josh-Gardner	player_GP
player_Josh-Gardner_GS	player_Josh-Gardner	player_GS
player_Josh-Gardner_A	player_Josh-Gardner	player_A
player_Josh-Gardner_GWA	player_Josh-Gardner	player_GWA
player_Josh-Gardner_HmA	player_Josh-Gardner	player_HmA
player_Josh-Gardner_RdA	player_Josh-Gardner	player_RdA
player_Josh-Gardner_A.90min	player_Josh-Gardner	player_A.90min
player_Ramon-Nunez_Club	player_Ramon-Nunez	player_Club
player_Ramon-Nunez_POS	player_Ramon-Nunez	player_POS
player_Ramon-Nunez_GP	player_Ramon-Nunez	player_GP
player_Ramon-Nunez_GS	player_Ramon-Nunez	player_GS
player_Ramon-Nunez_A	player_Ramon-Nunez	player_A
player_Ramon-Nunez_GWA	player_Ramon-Nunez	player_GWA
player_Ramon-Nunez_HmA	player_Ramon-Nunez	player_HmA
player_Ramon-Nunez_RdA	player_Ramon-Nunez	player_RdA
player_Ramon-Nunez_A.90min	player_Ramon-Nunez	player_A.90min
player_Conor-Casey_Club	player_Conor-Casey	player_Club
player_Conor-Casey_POS	player_Conor-Casey	player_POS
player_Conor-Casey_GP	player_Conor-Casey	player_GP
player_Conor-Casey_GS	player_Conor-Casey	player_GS
player_Conor-Casey_A	player_Conor-Casey	player_A
player_Conor-Casey_GWA	player_Conor-Casey	player_GWA
player_Conor-Casey_HmA	player_Conor-Casey	player_HmA
player_Conor-Casey_RdA	player_Conor-Casey	player_RdA
player_Conor-Casey_A.90min	player_Conor-Casey	player_A.90min
player_Andy-Williams_Club	player_Andy-Williams	player_Club
player_Andy-Williams_POS	player_Andy-Williams	player_POS
player_Andy-Williams_GP	player_Andy-Williams	player_GP
player_Andy-Williams_GS	player_Andy-Williams	player_GS
player_Andy-Williams_A	player_Andy-Williams	player_A
player_Andy-Williams_GWA	player_Andy-Williams	player_GWA
player_Andy-Williams_HmA	player_Andy-Williams	player_HmA
player_Andy-Williams_RdA	player_Andy-Williams	player_RdA
player_Andy-Williams_A.90min	player_Andy-Williams	player_A.90min
