player_Adam-Frye_Club	player_Adam-Frye	player_Club
player_Adam-Frye_POS	player_Adam-Frye	player_POS
player_Adam-Frye_GP	player_Adam-Frye	player_GP
player_Adam-Frye_GS	player_Adam-Frye	player_GS
player_Adam-Frye_A	player_Adam-Frye	player_A
player_Adam-Frye_GWA	player_Adam-Frye	player_GWA
player_Adam-Frye_HmA	player_Adam-Frye	player_HmA
player_Adam-Frye_RdA	player_Adam-Frye	player_RdA
player_Adam-Frye_A.90min	player_Adam-Frye	player_A.90min
player_Matt-McKeon_Club	player_Matt-McKeon	player_Club
player_Matt-McKeon_POS	player_Matt-McKeon	player_POS
player_Matt-McKeon_GP	player_Matt-McKeon	player_GP
player_Matt-McKeon_GS	player_Matt-McKeon	player_GS
player_Matt-McKeon_A	player_Matt-McKeon	player_A
player_Matt-McKeon_GWA	player_Matt-McKeon	player_GWA
player_Matt-McKeon_HmA	player_Matt-McKeon	player_HmA
player_Matt-McKeon_RdA	player_Matt-McKeon	player_RdA
player_Matt-McKeon_A.90min	player_Matt-McKeon	player_A.90min
player_David-Vaudreuil_Club	player_David-Vaudreuil	player_Club
player_David-Vaudreuil_POS	player_David-Vaudreuil	player_POS
player_David-Vaudreuil_GP	player_David-Vaudreuil	player_GP
player_David-Vaudreuil_GS	player_David-Vaudreuil	player_GS
player_David-Vaudreuil_A	player_David-Vaudreuil	player_A
player_David-Vaudreuil_GWA	player_David-Vaudreuil	player_GWA
player_David-Vaudreuil_HmA	player_David-Vaudreuil	player_HmA
player_David-Vaudreuil_RdA	player_David-Vaudreuil	player_RdA
player_David-Vaudreuil_A.90min	player_David-Vaudreuil	player_A.90min
player_Eddie-Pope_Club	player_Eddie-Pope	player_Club
player_Eddie-Pope_POS	player_Eddie-Pope	player_POS
player_Eddie-Pope_GP	player_Eddie-Pope	player_GP
player_Eddie-Pope_GS	player_Eddie-Pope	player_GS
player_Eddie-Pope_A	player_Eddie-Pope	player_A
player_Eddie-Pope_GWA	player_Eddie-Pope	player_GWA
player_Eddie-Pope_HmA	player_Eddie-Pope	player_HmA
player_Eddie-Pope_RdA	player_Eddie-Pope	player_RdA
player_Eddie-Pope_A.90min	player_Eddie-Pope	player_A.90min
player_Samuel-Ekeme_Club	player_Samuel-Ekeme	player_Club
player_Samuel-Ekeme_POS	player_Samuel-Ekeme	player_POS
player_Samuel-Ekeme_GP	player_Samuel-Ekeme	player_GP
player_Samuel-Ekeme_GS	player_Samuel-Ekeme	player_GS
player_Samuel-Ekeme_A	player_Samuel-Ekeme	player_A
player_Samuel-Ekeme_GWA	player_Samuel-Ekeme	player_GWA
player_Samuel-Ekeme_HmA	player_Samuel-Ekeme	player_HmA
player_Samuel-Ekeme_RdA	player_Samuel-Ekeme	player_RdA
player_Samuel-Ekeme_A.90min	player_Samuel-Ekeme	player_A.90min
player_Iain-Fraser_Club	player_Iain-Fraser	player_Club
player_Iain-Fraser_POS	player_Iain-Fraser	player_POS
player_Iain-Fraser_GP	player_Iain-Fraser	player_GP
player_Iain-Fraser_GS	player_Iain-Fraser	player_GS
player_Iain-Fraser_A	player_Iain-Fraser	player_A
player_Iain-Fraser_GWA	player_Iain-Fraser	player_GWA
player_Iain-Fraser_HmA	player_Iain-Fraser	player_HmA
player_Iain-Fraser_RdA	player_Iain-Fraser	player_RdA
player_Iain-Fraser_A.90min	player_Iain-Fraser	player_A.90min
player_Scott-Uderitz_Club	player_Scott-Uderitz	player_Club
player_Scott-Uderitz_POS	player_Scott-Uderitz	player_POS
player_Scott-Uderitz_GP	player_Scott-Uderitz	player_GP
player_Scott-Uderitz_GS	player_Scott-Uderitz	player_GS
player_Scott-Uderitz_A	player_Scott-Uderitz	player_A
player_Scott-Uderitz_GWA	player_Scott-Uderitz	player_GWA
player_Scott-Uderitz_HmA	player_Scott-Uderitz	player_HmA
player_Scott-Uderitz_RdA	player_Scott-Uderitz	player_RdA
player_Scott-Uderitz_A.90min	player_Scott-Uderitz	player_A.90min
player_Alexi-Lalas_Club	player_Alexi-Lalas	player_Club
player_Alexi-Lalas_POS	player_Alexi-Lalas	player_POS
player_Alexi-Lalas_GP	player_Alexi-Lalas	player_GP
player_Alexi-Lalas_GS	player_Alexi-Lalas	player_GS
player_Alexi-Lalas_A	player_Alexi-Lalas	player_A
player_Alexi-Lalas_GWA	player_Alexi-Lalas	player_GWA
player_Alexi-Lalas_HmA	player_Alexi-Lalas	player_HmA
player_Alexi-Lalas_RdA	player_Alexi-Lalas	player_RdA
player_Alexi-Lalas_A.90min	player_Alexi-Lalas	player_A.90min
player_Mike-Clark_Club	player_Mike-Clark	player_Club
player_Mike-Clark_POS	player_Mike-Clark	player_POS
player_Mike-Clark_GP	player_Mike-Clark	player_GP
player_Mike-Clark_GS	player_Mike-Clark	player_GS
player_Mike-Clark_A	player_Mike-Clark	player_A
player_Mike-Clark_GWA	player_Mike-Clark	player_GWA
player_Mike-Clark_HmA	player_Mike-Clark	player_HmA
player_Mike-Clark_RdA	player_Mike-Clark	player_RdA
player_Mike-Clark_A.90min	player_Mike-Clark	player_A.90min
player_Rhett-Harty_Club	player_Rhett-Harty	player_Club
player_Rhett-Harty_POS	player_Rhett-Harty	player_POS
player_Rhett-Harty_GP	player_Rhett-Harty	player_GP
player_Rhett-Harty_GS	player_Rhett-Harty	player_GS
player_Rhett-Harty_A	player_Rhett-Harty	player_A
player_Rhett-Harty_GWA	player_Rhett-Harty	player_GWA
player_Rhett-Harty_HmA	player_Rhett-Harty	player_HmA
player_Rhett-Harty_RdA	player_Rhett-Harty	player_RdA
player_Rhett-Harty_A.90min	player_Rhett-Harty	player_A.90min
player_Peter-Vermes_Club	player_Peter-Vermes	player_Club
player_Peter-Vermes_POS	player_Peter-Vermes	player_POS
player_Peter-Vermes_GP	player_Peter-Vermes	player_GP
player_Peter-Vermes_GS	player_Peter-Vermes	player_GS
player_Peter-Vermes_A	player_Peter-Vermes	player_A
player_Peter-Vermes_GWA	player_Peter-Vermes	player_GWA
player_Peter-Vermes_HmA	player_Peter-Vermes	player_HmA
player_Peter-Vermes_RdA	player_Peter-Vermes	player_RdA
player_Peter-Vermes_A.90min	player_Peter-Vermes	player_A.90min
player_Greg-Lalas_Club	player_Greg-Lalas	player_Club
player_Greg-Lalas_POS	player_Greg-Lalas	player_POS
player_Greg-Lalas_GP	player_Greg-Lalas	player_GP
player_Greg-Lalas_GS	player_Greg-Lalas	player_GS
player_Greg-Lalas_A	player_Greg-Lalas	player_A
player_Greg-Lalas_GWA	player_Greg-Lalas	player_GWA
player_Greg-Lalas_HmA	player_Greg-Lalas	player_HmA
player_Greg-Lalas_RdA	player_Greg-Lalas	player_RdA
player_Greg-Lalas_A.90min	player_Greg-Lalas	player_A.90min
player_Rene-Ortiz_Club	player_Rene-Ortiz	player_Club
player_Rene-Ortiz_POS	player_Rene-Ortiz	player_POS
player_Rene-Ortiz_GP	player_Rene-Ortiz	player_GP
player_Rene-Ortiz_GS	player_Rene-Ortiz	player_GS
player_Rene-Ortiz_A	player_Rene-Ortiz	player_A
player_Rene-Ortiz_GWA	player_Rene-Ortiz	player_GWA
player_Rene-Ortiz_HmA	player_Rene-Ortiz	player_HmA
player_Rene-Ortiz_RdA	player_Rene-Ortiz	player_RdA
player_Rene-Ortiz_A.90min	player_Rene-Ortiz	player_A.90min
player_Thor-Lee_Club	player_Thor-Lee	player_Club
player_Thor-Lee_POS	player_Thor-Lee	player_POS
player_Thor-Lee_GP	player_Thor-Lee	player_GP
player_Thor-Lee_GS	player_Thor-Lee	player_GS
player_Thor-Lee_A	player_Thor-Lee	player_A
player_Thor-Lee_GWA	player_Thor-Lee	player_GWA
player_Thor-Lee_HmA	player_Thor-Lee	player_HmA
player_Thor-Lee_RdA	player_Thor-Lee	player_RdA
player_Thor-Lee_A.90min	player_Thor-Lee	player_A.90min
player_Said-Fazlagic_Club	player_Said-Fazlagic	player_Club
player_Said-Fazlagic_POS	player_Said-Fazlagic	player_POS
player_Said-Fazlagic_GP	player_Said-Fazlagic	player_GP
player_Said-Fazlagic_GS	player_Said-Fazlagic	player_GS
player_Said-Fazlagic_A	player_Said-Fazlagic	player_A
player_Said-Fazlagic_GWA	player_Said-Fazlagic	player_GWA
player_Said-Fazlagic_HmA	player_Said-Fazlagic	player_HmA
player_Said-Fazlagic_RdA	player_Said-Fazlagic	player_RdA
player_Said-Fazlagic_A.90min	player_Said-Fazlagic	player_A.90min
player_Andrew-Restrepo_Club	player_Andrew-Restrepo	player_Club
player_Andrew-Restrepo_POS	player_Andrew-Restrepo	player_POS
player_Andrew-Restrepo_GP	player_Andrew-Restrepo	player_GP
player_Andrew-Restrepo_GS	player_Andrew-Restrepo	player_GS
player_Andrew-Restrepo_A	player_Andrew-Restrepo	player_A
player_Andrew-Restrepo_GWA	player_Andrew-Restrepo	player_GWA
player_Andrew-Restrepo_HmA	player_Andrew-Restrepo	player_HmA
player_Andrew-Restrepo_RdA	player_Andrew-Restrepo	player_RdA
player_Andrew-Restrepo_A.90min	player_Andrew-Restrepo	player_A.90min
player_Tom-Lips_Club	player_Tom-Lips	player_Club
player_Tom-Lips_POS	player_Tom-Lips	player_POS
player_Tom-Lips_GP	player_Tom-Lips	player_GP
player_Tom-Lips_GS	player_Tom-Lips	player_GS
player_Tom-Lips_A	player_Tom-Lips	player_A
player_Tom-Lips_GWA	player_Tom-Lips	player_GWA
player_Tom-Lips_HmA	player_Tom-Lips	player_HmA
player_Tom-Lips_RdA	player_Tom-Lips	player_RdA
player_Tom-Lips_A.90min	player_Tom-Lips	player_A.90min
player_John-Diffley_Club	player_John-Diffley	player_Club
player_John-Diffley_POS	player_John-Diffley	player_POS
player_John-Diffley_GP	player_John-Diffley	player_GP
player_John-Diffley_GS	player_John-Diffley	player_GS
player_John-Diffley_A	player_John-Diffley	player_A
player_John-Diffley_GWA	player_John-Diffley	player_GWA
player_John-Diffley_HmA	player_John-Diffley	player_HmA
player_John-Diffley_RdA	player_John-Diffley	player_RdA
player_John-Diffley_A.90min	player_John-Diffley	player_A.90min
player_Tommy-Reasoner_Club	player_Tommy-Reasoner	player_Club
player_Tommy-Reasoner_POS	player_Tommy-Reasoner	player_POS
player_Tommy-Reasoner_GP	player_Tommy-Reasoner	player_GP
player_Tommy-Reasoner_GS	player_Tommy-Reasoner	player_GS
player_Tommy-Reasoner_A	player_Tommy-Reasoner	player_A
player_Tommy-Reasoner_GWA	player_Tommy-Reasoner	player_GWA
player_Tommy-Reasoner_HmA	player_Tommy-Reasoner	player_HmA
player_Tommy-Reasoner_RdA	player_Tommy-Reasoner	player_RdA
player_Tommy-Reasoner_A.90min	player_Tommy-Reasoner	player_A.90min
player_Richard-Weiszmann_Club	player_Richard-Weiszmann	player_Club
player_Richard-Weiszmann_POS	player_Richard-Weiszmann	player_POS
player_Richard-Weiszmann_GP	player_Richard-Weiszmann	player_GP
player_Richard-Weiszmann_GS	player_Richard-Weiszmann	player_GS
player_Richard-Weiszmann_A	player_Richard-Weiszmann	player_A
player_Richard-Weiszmann_GWA	player_Richard-Weiszmann	player_GWA
player_Richard-Weiszmann_HmA	player_Richard-Weiszmann	player_HmA
player_Richard-Weiszmann_RdA	player_Richard-Weiszmann	player_RdA
player_Richard-Weiszmann_A.90min	player_Richard-Weiszmann	player_A.90min
player_Ted-Gillen_Club	player_Ted-Gillen	player_Club
player_Ted-Gillen_POS	player_Ted-Gillen	player_POS
player_Ted-Gillen_GP	player_Ted-Gillen	player_GP
player_Ted-Gillen_GS	player_Ted-Gillen	player_GS
player_Ted-Gillen_A	player_Ted-Gillen	player_A
player_Ted-Gillen_GWA	player_Ted-Gillen	player_GWA
player_Ted-Gillen_HmA	player_Ted-Gillen	player_HmA
player_Ted-Gillen_RdA	player_Ted-Gillen	player_RdA
player_Ted-Gillen_A.90min	player_Ted-Gillen	player_A.90min
player_Brandon-Pollard_Club	player_Brandon-Pollard	player_Club
player_Brandon-Pollard_POS	player_Brandon-Pollard	player_POS
player_Brandon-Pollard_GP	player_Brandon-Pollard	player_GP
player_Brandon-Pollard_GS	player_Brandon-Pollard	player_GS
player_Brandon-Pollard_A	player_Brandon-Pollard	player_A
player_Brandon-Pollard_GWA	player_Brandon-Pollard	player_GWA
player_Brandon-Pollard_HmA	player_Brandon-Pollard	player_HmA
player_Brandon-Pollard_RdA	player_Brandon-Pollard	player_RdA
player_Brandon-Pollard_A.90min	player_Brandon-Pollard	player_A.90min
player_Ted-Chronopoulos_Club	player_Ted-Chronopoulos	player_Club
player_Ted-Chronopoulos_POS	player_Ted-Chronopoulos	player_POS
player_Ted-Chronopoulos_GP	player_Ted-Chronopoulos	player_GP
player_Ted-Chronopoulos_GS	player_Ted-Chronopoulos	player_GS
player_Ted-Chronopoulos_A	player_Ted-Chronopoulos	player_A
player_Ted-Chronopoulos_GWA	player_Ted-Chronopoulos	player_GWA
player_Ted-Chronopoulos_HmA	player_Ted-Chronopoulos	player_HmA
player_Ted-Chronopoulos_RdA	player_Ted-Chronopoulos	player_RdA
player_Ted-Chronopoulos_A.90min	player_Ted-Chronopoulos	player_A.90min
player_Cristian-da-Silva_Club	player_Cristian-da-Silva	player_Club
player_Cristian-da-Silva_POS	player_Cristian-da-Silva	player_POS
player_Cristian-da-Silva_GP	player_Cristian-da-Silva	player_GP
player_Cristian-da-Silva_GS	player_Cristian-da-Silva	player_GS
player_Cristian-da-Silva_A	player_Cristian-da-Silva	player_A
player_Cristian-da-Silva_GWA	player_Cristian-da-Silva	player_GWA
player_Cristian-da-Silva_HmA	player_Cristian-da-Silva	player_HmA
player_Cristian-da-Silva_RdA	player_Cristian-da-Silva	player_RdA
player_Cristian-da-Silva_A.90min	player_Cristian-da-Silva	player_A.90min
player_Ed-Puskarich_Club	player_Ed-Puskarich	player_Club
player_Ed-Puskarich_POS	player_Ed-Puskarich	player_POS
player_Ed-Puskarich_GP	player_Ed-Puskarich	player_GP
player_Ed-Puskarich_GS	player_Ed-Puskarich	player_GS
player_Ed-Puskarich_A	player_Ed-Puskarich	player_A
player_Ed-Puskarich_GWA	player_Ed-Puskarich	player_GWA
player_Ed-Puskarich_HmA	player_Ed-Puskarich	player_HmA
player_Ed-Puskarich_RdA	player_Ed-Puskarich	player_RdA
player_Ed-Puskarich_A.90min	player_Ed-Puskarich	player_A.90min
player_Mark-Watson_Club	player_Mark-Watson	player_Club
player_Mark-Watson_POS	player_Mark-Watson	player_POS
player_Mark-Watson_GP	player_Mark-Watson	player_GP
player_Mark-Watson_GS	player_Mark-Watson	player_GS
player_Mark-Watson_A	player_Mark-Watson	player_A
player_Mark-Watson_GWA	player_Mark-Watson	player_GWA
player_Mark-Watson_HmA	player_Mark-Watson	player_HmA
player_Mark-Watson_RdA	player_Mark-Watson	player_RdA
player_Mark-Watson_A.90min	player_Mark-Watson	player_A.90min
player_Brian-Bliss_Club	player_Brian-Bliss	player_Club
player_Brian-Bliss_POS	player_Brian-Bliss	player_POS
player_Brian-Bliss_GP	player_Brian-Bliss	player_GP
player_Brian-Bliss_GS	player_Brian-Bliss	player_GS
player_Brian-Bliss_A	player_Brian-Bliss	player_A
player_Brian-Bliss_GWA	player_Brian-Bliss	player_GWA
player_Brian-Bliss_HmA	player_Brian-Bliss	player_HmA
player_Brian-Bliss_RdA	player_Brian-Bliss	player_RdA
player_Brian-Bliss_A.90min	player_Brian-Bliss	player_A.90min
player_Jeff-Zaun_Club	player_Jeff-Zaun	player_Club
player_Jeff-Zaun_POS	player_Jeff-Zaun	player_POS
player_Jeff-Zaun_GP	player_Jeff-Zaun	player_GP
player_Jeff-Zaun_GS	player_Jeff-Zaun	player_GS
player_Jeff-Zaun_A	player_Jeff-Zaun	player_A
player_Jeff-Zaun_GWA	player_Jeff-Zaun	player_GWA
player_Jeff-Zaun_HmA	player_Jeff-Zaun	player_HmA
player_Jeff-Zaun_RdA	player_Jeff-Zaun	player_RdA
player_Jeff-Zaun_A.90min	player_Jeff-Zaun	player_A.90min
player_Matt-Knowles_Club	player_Matt-Knowles	player_Club
player_Matt-Knowles_POS	player_Matt-Knowles	player_POS
player_Matt-Knowles_GP	player_Matt-Knowles	player_GP
player_Matt-Knowles_GS	player_Matt-Knowles	player_GS
player_Matt-Knowles_A	player_Matt-Knowles	player_A
player_Matt-Knowles_GWA	player_Matt-Knowles	player_GWA
player_Matt-Knowles_HmA	player_Matt-Knowles	player_HmA
player_Matt-Knowles_RdA	player_Matt-Knowles	player_RdA
player_Matt-Knowles_A.90min	player_Matt-Knowles	player_A.90min
player_Clint-Peay_Club	player_Clint-Peay	player_Club
player_Clint-Peay_POS	player_Clint-Peay	player_POS
player_Clint-Peay_GP	player_Clint-Peay	player_GP
player_Clint-Peay_GS	player_Clint-Peay	player_GS
player_Clint-Peay_A	player_Clint-Peay	player_A
player_Clint-Peay_GWA	player_Clint-Peay	player_GWA
player_Clint-Peay_HmA	player_Clint-Peay	player_HmA
player_Clint-Peay_RdA	player_Clint-Peay	player_RdA
player_Clint-Peay_A.90min	player_Clint-Peay	player_A.90min
player_Francis-Okaroh_Club	player_Francis-Okaroh	player_Club
player_Francis-Okaroh_POS	player_Francis-Okaroh	player_POS
player_Francis-Okaroh_GP	player_Francis-Okaroh	player_GP
player_Francis-Okaroh_GS	player_Francis-Okaroh	player_GS
player_Francis-Okaroh_A	player_Francis-Okaroh	player_A
player_Francis-Okaroh_GWA	player_Francis-Okaroh	player_GWA
player_Francis-Okaroh_HmA	player_Francis-Okaroh	player_HmA
player_Francis-Okaroh_RdA	player_Francis-Okaroh	player_RdA
player_Francis-Okaroh_A.90min	player_Francis-Okaroh	player_A.90min
player_Nicola-Caricola_Club	player_Nicola-Caricola	player_Club
player_Nicola-Caricola_POS	player_Nicola-Caricola	player_POS
player_Nicola-Caricola_GP	player_Nicola-Caricola	player_GP
player_Nicola-Caricola_GS	player_Nicola-Caricola	player_GS
player_Nicola-Caricola_A	player_Nicola-Caricola	player_A
player_Nicola-Caricola_GWA	player_Nicola-Caricola	player_GWA
player_Nicola-Caricola_HmA	player_Nicola-Caricola	player_HmA
player_Nicola-Caricola_RdA	player_Nicola-Caricola	player_RdA
player_Nicola-Caricola_A.90min	player_Nicola-Caricola	player_A.90min
player_Frank-Yallop_Club	player_Frank-Yallop	player_Club
player_Frank-Yallop_POS	player_Frank-Yallop	player_POS
player_Frank-Yallop_GP	player_Frank-Yallop	player_GP
player_Frank-Yallop_GS	player_Frank-Yallop	player_GS
player_Frank-Yallop_A	player_Frank-Yallop	player_A
player_Frank-Yallop_GWA	player_Frank-Yallop	player_GWA
player_Frank-Yallop_HmA	player_Frank-Yallop	player_HmA
player_Frank-Yallop_RdA	player_Frank-Yallop	player_RdA
player_Frank-Yallop_A.90min	player_Frank-Yallop	player_A.90min
player_Uche-Okafor_Club	player_Uche-Okafor	player_Club
player_Uche-Okafor_POS	player_Uche-Okafor	player_POS
player_Uche-Okafor_GP	player_Uche-Okafor	player_GP
player_Uche-Okafor_GS	player_Uche-Okafor	player_GS
player_Uche-Okafor_A	player_Uche-Okafor	player_A
player_Uche-Okafor_GWA	player_Uche-Okafor	player_GWA
player_Uche-Okafor_HmA	player_Uche-Okafor	player_HmA
player_Uche-Okafor_RdA	player_Uche-Okafor	player_RdA
player_Uche-Okafor_A.90min	player_Uche-Okafor	player_A.90min
player_Richard-Farrer_Club	player_Richard-Farrer	player_Club
player_Richard-Farrer_POS	player_Richard-Farrer	player_POS
player_Richard-Farrer_GP	player_Richard-Farrer	player_GP
player_Richard-Farrer_GS	player_Richard-Farrer	player_GS
player_Richard-Farrer_A	player_Richard-Farrer	player_A
player_Richard-Farrer_GWA	player_Richard-Farrer	player_GWA
player_Richard-Farrer_HmA	player_Richard-Farrer	player_HmA
player_Richard-Farrer_RdA	player_Richard-Farrer	player_RdA
player_Richard-Farrer_A.90min	player_Richard-Farrer	player_A.90min
player_Thomas-Dooley_Club	player_Thomas-Dooley	player_Club
player_Thomas-Dooley_POS	player_Thomas-Dooley	player_POS
player_Thomas-Dooley_GP	player_Thomas-Dooley	player_GP
player_Thomas-Dooley_GS	player_Thomas-Dooley	player_GS
player_Thomas-Dooley_A	player_Thomas-Dooley	player_A
player_Thomas-Dooley_GWA	player_Thomas-Dooley	player_GWA
player_Thomas-Dooley_HmA	player_Thomas-Dooley	player_HmA
player_Thomas-Dooley_RdA	player_Thomas-Dooley	player_RdA
player_Thomas-Dooley_A.90min	player_Thomas-Dooley	player_A.90min
player_Richard-Gough_Club	player_Richard-Gough	player_Club
player_Richard-Gough_POS	player_Richard-Gough	player_POS
player_Richard-Gough_GP	player_Richard-Gough	player_GP
player_Richard-Gough_GS	player_Richard-Gough	player_GS
player_Richard-Gough_A	player_Richard-Gough	player_A
player_Richard-Gough_GWA	player_Richard-Gough	player_GWA
player_Richard-Gough_HmA	player_Richard-Gough	player_HmA
player_Richard-Gough_RdA	player_Richard-Gough	player_RdA
player_Richard-Gough_A.90min	player_Richard-Gough	player_A.90min
player_Wade-Webber_Club	player_Wade-Webber	player_Club
player_Wade-Webber_POS	player_Wade-Webber	player_POS
player_Wade-Webber_GP	player_Wade-Webber	player_GP
player_Wade-Webber_GS	player_Wade-Webber	player_GS
player_Wade-Webber_A	player_Wade-Webber	player_A
player_Wade-Webber_GWA	player_Wade-Webber	player_GWA
player_Wade-Webber_HmA	player_Wade-Webber	player_HmA
player_Wade-Webber_RdA	player_Wade-Webber	player_RdA
player_Wade-Webber_A.90min	player_Wade-Webber	player_A.90min
player_Jorge-Rodriguez_Club	player_Jorge-Rodriguez	player_Club
player_Jorge-Rodriguez_POS	player_Jorge-Rodriguez	player_POS
player_Jorge-Rodriguez_GP	player_Jorge-Rodriguez	player_GP
player_Jorge-Rodriguez_GS	player_Jorge-Rodriguez	player_GS
player_Jorge-Rodriguez_A	player_Jorge-Rodriguez	player_A
player_Jorge-Rodriguez_GWA	player_Jorge-Rodriguez	player_GWA
player_Jorge-Rodriguez_HmA	player_Jorge-Rodriguez	player_HmA
player_Jorge-Rodriguez_RdA	player_Jorge-Rodriguez	player_RdA
player_Jorge-Rodriguez_A.90min	player_Jorge-Rodriguez	player_A.90min
player_Diego-Gutierrez_Club	player_Diego-Gutierrez	player_Club
player_Diego-Gutierrez_POS	player_Diego-Gutierrez	player_POS
player_Diego-Gutierrez_GP	player_Diego-Gutierrez	player_GP
player_Diego-Gutierrez_GS	player_Diego-Gutierrez	player_GS
player_Diego-Gutierrez_A	player_Diego-Gutierrez	player_A
player_Diego-Gutierrez_GWA	player_Diego-Gutierrez	player_GWA
player_Diego-Gutierrez_HmA	player_Diego-Gutierrez	player_HmA
player_Diego-Gutierrez_RdA	player_Diego-Gutierrez	player_RdA
player_Diego-Gutierrez_A.90min	player_Diego-Gutierrez	player_A.90min
player_Dionysus-Sebwe_Club	player_Dionysus-Sebwe	player_Club
player_Dionysus-Sebwe_POS	player_Dionysus-Sebwe	player_POS
player_Dionysus-Sebwe_GP	player_Dionysus-Sebwe	player_GP
player_Dionysus-Sebwe_GS	player_Dionysus-Sebwe	player_GS
player_Dionysus-Sebwe_A	player_Dionysus-Sebwe	player_A
player_Dionysus-Sebwe_GWA	player_Dionysus-Sebwe	player_GWA
player_Dionysus-Sebwe_HmA	player_Dionysus-Sebwe	player_HmA
player_Dionysus-Sebwe_RdA	player_Dionysus-Sebwe	player_RdA
player_Dionysus-Sebwe_A.90min	player_Dionysus-Sebwe	player_A.90min
player_David-Moxom_Club	player_David-Moxom	player_Club
player_David-Moxom_POS	player_David-Moxom	player_POS
player_David-Moxom_GP	player_David-Moxom	player_GP
player_David-Moxom_GS	player_David-Moxom	player_GS
player_David-Moxom_A	player_David-Moxom	player_A
player_David-Moxom_GWA	player_David-Moxom	player_GWA
player_David-Moxom_HmA	player_David-Moxom	player_HmA
player_David-Moxom_RdA	player_David-Moxom	player_RdA
player_David-Moxom_A.90min	player_David-Moxom	player_A.90min
player_Ubusuku-Abukusumo_Club	player_Ubusuku-Abukusumo	player_Club
player_Ubusuku-Abukusumo_POS	player_Ubusuku-Abukusumo	player_POS
player_Ubusuku-Abukusumo_GP	player_Ubusuku-Abukusumo	player_GP
player_Ubusuku-Abukusumo_GS	player_Ubusuku-Abukusumo	player_GS
player_Ubusuku-Abukusumo_A	player_Ubusuku-Abukusumo	player_A
player_Ubusuku-Abukusumo_GWA	player_Ubusuku-Abukusumo	player_GWA
player_Ubusuku-Abukusumo_HmA	player_Ubusuku-Abukusumo	player_HmA
player_Ubusuku-Abukusumo_RdA	player_Ubusuku-Abukusumo	player_RdA
player_Ubusuku-Abukusumo_A.90min	player_Ubusuku-Abukusumo	player_A.90min
player_Marco-Rizi_Club	player_Marco-Rizi	player_Club
player_Marco-Rizi_POS	player_Marco-Rizi	player_POS
player_Marco-Rizi_GP	player_Marco-Rizi	player_GP
player_Marco-Rizi_GS	player_Marco-Rizi	player_GS
player_Marco-Rizi_A	player_Marco-Rizi	player_A
player_Marco-Rizi_GWA	player_Marco-Rizi	player_GWA
player_Marco-Rizi_HmA	player_Marco-Rizi	player_HmA
player_Marco-Rizi_RdA	player_Marco-Rizi	player_RdA
player_Marco-Rizi_A.90min	player_Marco-Rizi	player_A.90min
player_Brian-Dunseth_Club	player_Brian-Dunseth	player_Club
player_Brian-Dunseth_POS	player_Brian-Dunseth	player_POS
player_Brian-Dunseth_GP	player_Brian-Dunseth	player_GP
player_Brian-Dunseth_GS	player_Brian-Dunseth	player_GS
player_Brian-Dunseth_A	player_Brian-Dunseth	player_A
player_Brian-Dunseth_GWA	player_Brian-Dunseth	player_GWA
player_Brian-Dunseth_HmA	player_Brian-Dunseth	player_HmA
player_Brian-Dunseth_RdA	player_Brian-Dunseth	player_RdA
player_Brian-Dunseth_A.90min	player_Brian-Dunseth	player_A.90min
player_Joao-Luiz_Club	player_Joao-Luiz	player_Club
player_Joao-Luiz_POS	player_Joao-Luiz	player_POS
player_Joao-Luiz_GP	player_Joao-Luiz	player_GP
player_Joao-Luiz_GS	player_Joao-Luiz	player_GS
player_Joao-Luiz_A	player_Joao-Luiz	player_A
player_Joao-Luiz_GWA	player_Joao-Luiz	player_GWA
player_Joao-Luiz_HmA	player_Joao-Luiz	player_HmA
player_Joao-Luiz_RdA	player_Joao-Luiz	player_RdA
player_Joao-Luiz_A.90min	player_Joao-Luiz	player_A.90min
player_Mario-Gori_Club	player_Mario-Gori	player_Club
player_Mario-Gori_POS	player_Mario-Gori	player_POS
player_Mario-Gori_GP	player_Mario-Gori	player_GP
player_Mario-Gori_GS	player_Mario-Gori	player_GS
player_Mario-Gori_A	player_Mario-Gori	player_A
player_Mario-Gori_GWA	player_Mario-Gori	player_GWA
player_Mario-Gori_HmA	player_Mario-Gori	player_HmA
player_Mario-Gori_RdA	player_Mario-Gori	player_RdA
player_Mario-Gori_A.90min	player_Mario-Gori	player_A.90min
player_John-DeBrito_Club	player_John-DeBrito	player_Club
player_John-DeBrito_POS	player_John-DeBrito	player_POS
player_John-DeBrito_GP	player_John-DeBrito	player_GP
player_John-DeBrito_GS	player_John-DeBrito	player_GS
player_John-DeBrito_A	player_John-DeBrito	player_A
player_John-DeBrito_GWA	player_John-DeBrito	player_GWA
player_John-DeBrito_HmA	player_John-DeBrito	player_HmA
player_John-DeBrito_RdA	player_John-DeBrito	player_RdA
player_John-DeBrito_A.90min	player_John-DeBrito	player_A.90min
player_Eric-Dade_Club	player_Eric-Dade	player_Club
player_Eric-Dade_POS	player_Eric-Dade	player_POS
player_Eric-Dade_GP	player_Eric-Dade	player_GP
player_Eric-Dade_GS	player_Eric-Dade	player_GS
player_Eric-Dade_A	player_Eric-Dade	player_A
player_Eric-Dade_GWA	player_Eric-Dade	player_GWA
player_Eric-Dade_HmA	player_Eric-Dade	player_HmA
player_Eric-Dade_RdA	player_Eric-Dade	player_RdA
player_Eric-Dade_A.90min	player_Eric-Dade	player_A.90min
player_Joey-Martinez_Club	player_Joey-Martinez	player_Club
player_Joey-Martinez_POS	player_Joey-Martinez	player_POS
player_Joey-Martinez_GP	player_Joey-Martinez	player_GP
player_Joey-Martinez_GS	player_Joey-Martinez	player_GS
player_Joey-Martinez_A	player_Joey-Martinez	player_A
player_Joey-Martinez_GWA	player_Joey-Martinez	player_GWA
player_Joey-Martinez_HmA	player_Joey-Martinez	player_HmA
player_Joey-Martinez_RdA	player_Joey-Martinez	player_RdA
player_Joey-Martinez_A.90min	player_Joey-Martinez	player_A.90min
player_Carlos-Llamosa_Club	player_Carlos-Llamosa	player_Club
player_Carlos-Llamosa_POS	player_Carlos-Llamosa	player_POS
player_Carlos-Llamosa_GP	player_Carlos-Llamosa	player_GP
player_Carlos-Llamosa_GS	player_Carlos-Llamosa	player_GS
player_Carlos-Llamosa_A	player_Carlos-Llamosa	player_A
player_Carlos-Llamosa_GWA	player_Carlos-Llamosa	player_GWA
player_Carlos-Llamosa_HmA	player_Carlos-Llamosa	player_HmA
player_Carlos-Llamosa_RdA	player_Carlos-Llamosa	player_RdA
player_Carlos-Llamosa_A.90min	player_Carlos-Llamosa	player_A.90min
player_Ansil-Elcock_Club	player_Ansil-Elcock	player_Club
player_Ansil-Elcock_POS	player_Ansil-Elcock	player_POS
player_Ansil-Elcock_GP	player_Ansil-Elcock	player_GP
player_Ansil-Elcock_GS	player_Ansil-Elcock	player_GS
player_Ansil-Elcock_A	player_Ansil-Elcock	player_A
player_Ansil-Elcock_GWA	player_Ansil-Elcock	player_GWA
player_Ansil-Elcock_HmA	player_Ansil-Elcock	player_HmA
player_Ansil-Elcock_RdA	player_Ansil-Elcock	player_RdA
player_Ansil-Elcock_A.90min	player_Ansil-Elcock	player_A.90min
player_Leonardo-Squadrone_Club	player_Leonardo-Squadrone	player_Club
player_Leonardo-Squadrone_POS	player_Leonardo-Squadrone	player_POS
player_Leonardo-Squadrone_GP	player_Leonardo-Squadrone	player_GP
player_Leonardo-Squadrone_GS	player_Leonardo-Squadrone	player_GS
player_Leonardo-Squadrone_A	player_Leonardo-Squadrone	player_A
player_Leonardo-Squadrone_GWA	player_Leonardo-Squadrone	player_GWA
player_Leonardo-Squadrone_HmA	player_Leonardo-Squadrone	player_HmA
player_Leonardo-Squadrone_RdA	player_Leonardo-Squadrone	player_RdA
player_Leonardo-Squadrone_A.90min	player_Leonardo-Squadrone	player_A.90min
player_Sean-Bowers_Club	player_Sean-Bowers	player_Club
player_Sean-Bowers_POS	player_Sean-Bowers	player_POS
player_Sean-Bowers_GP	player_Sean-Bowers	player_GP
player_Sean-Bowers_GS	player_Sean-Bowers	player_GS
player_Sean-Bowers_A	player_Sean-Bowers	player_A
player_Sean-Bowers_GWA	player_Sean-Bowers	player_GWA
player_Sean-Bowers_HmA	player_Sean-Bowers	player_HmA
player_Sean-Bowers_RdA	player_Sean-Bowers	player_RdA
player_Sean-Bowers_A.90min	player_Sean-Bowers	player_A.90min
player_Steve-Pittman_Club	player_Steve-Pittman	player_Club
player_Steve-Pittman_POS	player_Steve-Pittman	player_POS
player_Steve-Pittman_GP	player_Steve-Pittman	player_GP
player_Steve-Pittman_GS	player_Steve-Pittman	player_GS
player_Steve-Pittman_A	player_Steve-Pittman	player_A
player_Steve-Pittman_GWA	player_Steve-Pittman	player_GWA
player_Steve-Pittman_HmA	player_Steve-Pittman	player_HmA
player_Steve-Pittman_RdA	player_Steve-Pittman	player_RdA
player_Steve-Pittman_A.90min	player_Steve-Pittman	player_A.90min
player_Mike-Duhaney_Club	player_Mike-Duhaney	player_Club
player_Mike-Duhaney_POS	player_Mike-Duhaney	player_POS
player_Mike-Duhaney_GP	player_Mike-Duhaney	player_GP
player_Mike-Duhaney_GS	player_Mike-Duhaney	player_GS
player_Mike-Duhaney_A	player_Mike-Duhaney	player_A
player_Mike-Duhaney_GWA	player_Mike-Duhaney	player_GWA
player_Mike-Duhaney_HmA	player_Mike-Duhaney	player_HmA
player_Mike-Duhaney_RdA	player_Mike-Duhaney	player_RdA
player_Mike-Duhaney_A.90min	player_Mike-Duhaney	player_A.90min
player_John-Maessner_Club	player_John-Maessner	player_Club
player_John-Maessner_POS	player_John-Maessner	player_POS
player_John-Maessner_GP	player_John-Maessner	player_GP
player_John-Maessner_GS	player_John-Maessner	player_GS
player_John-Maessner_A	player_John-Maessner	player_A
player_John-Maessner_GWA	player_John-Maessner	player_GWA
player_John-Maessner_HmA	player_John-Maessner	player_HmA
player_John-Maessner_RdA	player_John-Maessner	player_RdA
player_John-Maessner_A.90min	player_John-Maessner	player_A.90min
player_Frankie-Hejduk_Club	player_Frankie-Hejduk	player_Club
player_Frankie-Hejduk_POS	player_Frankie-Hejduk	player_POS
player_Frankie-Hejduk_GP	player_Frankie-Hejduk	player_GP
player_Frankie-Hejduk_GS	player_Frankie-Hejduk	player_GS
player_Frankie-Hejduk_A	player_Frankie-Hejduk	player_A
player_Frankie-Hejduk_GWA	player_Frankie-Hejduk	player_GWA
player_Frankie-Hejduk_HmA	player_Frankie-Hejduk	player_HmA
player_Frankie-Hejduk_RdA	player_Frankie-Hejduk	player_RdA
player_Frankie-Hejduk_A.90min	player_Frankie-Hejduk	player_A.90min
player_Arley-Palacios_Club	player_Arley-Palacios	player_Club
player_Arley-Palacios_POS	player_Arley-Palacios	player_POS
player_Arley-Palacios_GP	player_Arley-Palacios	player_GP
player_Arley-Palacios_GS	player_Arley-Palacios	player_GS
player_Arley-Palacios_A	player_Arley-Palacios	player_A
player_Arley-Palacios_GWA	player_Arley-Palacios	player_GWA
player_Arley-Palacios_HmA	player_Arley-Palacios	player_HmA
player_Arley-Palacios_RdA	player_Arley-Palacios	player_RdA
player_Arley-Palacios_A.90min	player_Arley-Palacios	player_A.90min
player_Mike-Petke_Club	player_Mike-Petke	player_Club
player_Mike-Petke_POS	player_Mike-Petke	player_POS
player_Mike-Petke_GP	player_Mike-Petke	player_GP
player_Mike-Petke_GS	player_Mike-Petke	player_GS
player_Mike-Petke_A	player_Mike-Petke	player_A
player_Mike-Petke_GWA	player_Mike-Petke	player_GWA
player_Mike-Petke_HmA	player_Mike-Petke	player_HmA
player_Mike-Petke_RdA	player_Mike-Petke	player_RdA
player_Mike-Petke_A.90min	player_Mike-Petke	player_A.90min
player_Ivan-McKinley_Club	player_Ivan-McKinley	player_Club
player_Ivan-McKinley_POS	player_Ivan-McKinley	player_POS
player_Ivan-McKinley_GP	player_Ivan-McKinley	player_GP
player_Ivan-McKinley_GS	player_Ivan-McKinley	player_GS
player_Ivan-McKinley_A	player_Ivan-McKinley	player_A
player_Ivan-McKinley_GWA	player_Ivan-McKinley	player_GWA
player_Ivan-McKinley_HmA	player_Ivan-McKinley	player_HmA
player_Ivan-McKinley_RdA	player_Ivan-McKinley	player_RdA
player_Ivan-McKinley_A.90min	player_Ivan-McKinley	player_A.90min
player_Jan-Eriksson_Club	player_Jan-Eriksson	player_Club
player_Jan-Eriksson_POS	player_Jan-Eriksson	player_POS
player_Jan-Eriksson_GP	player_Jan-Eriksson	player_GP
player_Jan-Eriksson_GS	player_Jan-Eriksson	player_GS
player_Jan-Eriksson_A	player_Jan-Eriksson	player_A
player_Jan-Eriksson_GWA	player_Jan-Eriksson	player_GWA
player_Jan-Eriksson_HmA	player_Jan-Eriksson	player_HmA
player_Jan-Eriksson_RdA	player_Jan-Eriksson	player_RdA
player_Jan-Eriksson_A.90min	player_Jan-Eriksson	player_A.90min
player_Kevin-Coye_Club	player_Kevin-Coye	player_Club
player_Kevin-Coye_POS	player_Kevin-Coye	player_POS
player_Kevin-Coye_GP	player_Kevin-Coye	player_GP
player_Kevin-Coye_GS	player_Kevin-Coye	player_GS
player_Kevin-Coye_A	player_Kevin-Coye	player_A
player_Kevin-Coye_GWA	player_Kevin-Coye	player_GWA
player_Kevin-Coye_HmA	player_Kevin-Coye	player_HmA
player_Kevin-Coye_RdA	player_Kevin-Coye	player_RdA
player_Kevin-Coye_A.90min	player_Kevin-Coye	player_A.90min
player_Chuck-Codd_Club	player_Chuck-Codd	player_Club
player_Chuck-Codd_POS	player_Chuck-Codd	player_POS
player_Chuck-Codd_GP	player_Chuck-Codd	player_GP
player_Chuck-Codd_GS	player_Chuck-Codd	player_GS
player_Chuck-Codd_A	player_Chuck-Codd	player_A
player_Chuck-Codd_GWA	player_Chuck-Codd	player_GWA
player_Chuck-Codd_HmA	player_Chuck-Codd	player_HmA
player_Chuck-Codd_RdA	player_Chuck-Codd	player_RdA
player_Chuck-Codd_A.90min	player_Chuck-Codd	player_A.90min
player_Zion-Renfrum_Club	player_Zion-Renfrum	player_Club
player_Zion-Renfrum_POS	player_Zion-Renfrum	player_POS
player_Zion-Renfrum_GP	player_Zion-Renfrum	player_GP
player_Zion-Renfrum_GS	player_Zion-Renfrum	player_GS
player_Zion-Renfrum_A	player_Zion-Renfrum	player_A
player_Zion-Renfrum_GWA	player_Zion-Renfrum	player_GWA
player_Zion-Renfrum_HmA	player_Zion-Renfrum	player_HmA
player_Zion-Renfrum_RdA	player_Zion-Renfrum	player_RdA
player_Zion-Renfrum_A.90min	player_Zion-Renfrum	player_A.90min
player_Michael-Richardson_Club	player_Michael-Richardson	player_Club
player_Michael-Richardson_POS	player_Michael-Richardson	player_POS
player_Michael-Richardson_GP	player_Michael-Richardson	player_GP
player_Michael-Richardson_GS	player_Michael-Richardson	player_GS
player_Michael-Richardson_A	player_Michael-Richardson	player_A
player_Michael-Richardson_GWA	player_Michael-Richardson	player_GWA
player_Michael-Richardson_HmA	player_Michael-Richardson	player_HmA
player_Michael-Richardson_RdA	player_Michael-Richardson	player_RdA
player_Michael-Richardson_A.90min	player_Michael-Richardson	player_A.90min
player_Chris-Brown_Club	player_Chris-Brown	player_Club
player_Chris-Brown_POS	player_Chris-Brown	player_POS
player_Chris-Brown_GP	player_Chris-Brown	player_GP
player_Chris-Brown_GS	player_Chris-Brown	player_GS
player_Chris-Brown_A	player_Chris-Brown	player_A
player_Chris-Brown_GWA	player_Chris-Brown	player_GWA
player_Chris-Brown_HmA	player_Chris-Brown	player_HmA
player_Chris-Brown_RdA	player_Chris-Brown	player_RdA
player_Chris-Brown_A.90min	player_Chris-Brown	player_A.90min
player_Danny-Care_Club	player_Danny-Care	player_Club
player_Danny-Care_POS	player_Danny-Care	player_POS
player_Danny-Care_GP	player_Danny-Care	player_GP
player_Danny-Care_GS	player_Danny-Care	player_GS
player_Danny-Care_A	player_Danny-Care	player_A
player_Danny-Care_GWA	player_Danny-Care	player_GWA
player_Danny-Care_HmA	player_Danny-Care	player_HmA
player_Danny-Care_RdA	player_Danny-Care	player_RdA
player_Danny-Care_A.90min	player_Danny-Care	player_A.90min
player_R.T.-Moore_Club	player_R.T.-Moore	player_Club
player_R.T.-Moore_POS	player_R.T.-Moore	player_POS
player_R.T.-Moore_GP	player_R.T.-Moore	player_GP
player_R.T.-Moore_GS	player_R.T.-Moore	player_GS
player_R.T.-Moore_A	player_R.T.-Moore	player_A
player_R.T.-Moore_GWA	player_R.T.-Moore	player_GWA
player_R.T.-Moore_HmA	player_R.T.-Moore	player_HmA
player_R.T.-Moore_RdA	player_R.T.-Moore	player_RdA
player_R.T.-Moore_A.90min	player_R.T.-Moore	player_A.90min
player_Curt-Onalfo_Club	player_Curt-Onalfo	player_Club
player_Curt-Onalfo_POS	player_Curt-Onalfo	player_POS
player_Curt-Onalfo_GP	player_Curt-Onalfo	player_GP
player_Curt-Onalfo_GS	player_Curt-Onalfo	player_GS
player_Curt-Onalfo_A	player_Curt-Onalfo	player_A
player_Curt-Onalfo_GWA	player_Curt-Onalfo	player_GWA
player_Curt-Onalfo_HmA	player_Curt-Onalfo	player_HmA
player_Curt-Onalfo_RdA	player_Curt-Onalfo	player_RdA
player_Curt-Onalfo_A.90min	player_Curt-Onalfo	player_A.90min
player_Dahir-Mohammed_Club	player_Dahir-Mohammed	player_Club
player_Dahir-Mohammed_POS	player_Dahir-Mohammed	player_POS
player_Dahir-Mohammed_GP	player_Dahir-Mohammed	player_GP
player_Dahir-Mohammed_GS	player_Dahir-Mohammed	player_GS
player_Dahir-Mohammed_A	player_Dahir-Mohammed	player_A
player_Dahir-Mohammed_GWA	player_Dahir-Mohammed	player_GWA
player_Dahir-Mohammed_HmA	player_Dahir-Mohammed	player_HmA
player_Dahir-Mohammed_RdA	player_Dahir-Mohammed	player_RdA
player_Dahir-Mohammed_A.90min	player_Dahir-Mohammed	player_A.90min
player_Chad-McCarty_Club	player_Chad-McCarty	player_Club
player_Chad-McCarty_POS	player_Chad-McCarty	player_POS
player_Chad-McCarty_GP	player_Chad-McCarty	player_GP
player_Chad-McCarty_GS	player_Chad-McCarty	player_GS
player_Chad-McCarty_A	player_Chad-McCarty	player_A
player_Chad-McCarty_GWA	player_Chad-McCarty	player_GWA
player_Chad-McCarty_HmA	player_Chad-McCarty	player_HmA
player_Chad-McCarty_RdA	player_Chad-McCarty	player_RdA
player_Chad-McCarty_A.90min	player_Chad-McCarty	player_A.90min
player_Mike-Lapper_Club	player_Mike-Lapper	player_Club
player_Mike-Lapper_POS	player_Mike-Lapper	player_POS
player_Mike-Lapper_GP	player_Mike-Lapper	player_GP
player_Mike-Lapper_GS	player_Mike-Lapper	player_GS
player_Mike-Lapper_A	player_Mike-Lapper	player_A
player_Mike-Lapper_GWA	player_Mike-Lapper	player_GWA
player_Mike-Lapper_HmA	player_Mike-Lapper	player_HmA
player_Mike-Lapper_RdA	player_Mike-Lapper	player_RdA
player_Mike-Lapper_A.90min	player_Mike-Lapper	player_A.90min
player_Mark-Semioli_Club	player_Mark-Semioli	player_Club
player_Mark-Semioli_POS	player_Mark-Semioli	player_POS
player_Mark-Semioli_GP	player_Mark-Semioli	player_GP
player_Mark-Semioli_GS	player_Mark-Semioli	player_GS
player_Mark-Semioli_A	player_Mark-Semioli	player_A
player_Mark-Semioli_GWA	player_Mark-Semioli	player_GWA
player_Mark-Semioli_HmA	player_Mark-Semioli	player_HmA
player_Mark-Semioli_RdA	player_Mark-Semioli	player_RdA
player_Mark-Semioli_A.90min	player_Mark-Semioli	player_A.90min
player_Cle-Kooiman_Club	player_Cle-Kooiman	player_Club
player_Cle-Kooiman_POS	player_Cle-Kooiman	player_POS
player_Cle-Kooiman_GP	player_Cle-Kooiman	player_GP
player_Cle-Kooiman_GS	player_Cle-Kooiman	player_GS
player_Cle-Kooiman_A	player_Cle-Kooiman	player_A
player_Cle-Kooiman_GWA	player_Cle-Kooiman	player_GWA
player_Cle-Kooiman_HmA	player_Cle-Kooiman	player_HmA
player_Cle-Kooiman_RdA	player_Cle-Kooiman	player_RdA
player_Cle-Kooiman_A.90min	player_Cle-Kooiman	player_A.90min
player_Tom-Soehn_Club	player_Tom-Soehn	player_Club
player_Tom-Soehn_POS	player_Tom-Soehn	player_POS
player_Tom-Soehn_GP	player_Tom-Soehn	player_GP
player_Tom-Soehn_GS	player_Tom-Soehn	player_GS
player_Tom-Soehn_A	player_Tom-Soehn	player_A
player_Tom-Soehn_GWA	player_Tom-Soehn	player_GWA
player_Tom-Soehn_HmA	player_Tom-Soehn	player_HmA
player_Tom-Soehn_RdA	player_Tom-Soehn	player_RdA
player_Tom-Soehn_A.90min	player_Tom-Soehn	player_A.90min
player_C.J.-Brown_Club	player_C.J.-Brown	player_Club
player_C.J.-Brown_POS	player_C.J.-Brown	player_POS
player_C.J.-Brown_GP	player_C.J.-Brown	player_GP
player_C.J.-Brown_GS	player_C.J.-Brown	player_GS
player_C.J.-Brown_A	player_C.J.-Brown	player_A
player_C.J.-Brown_GWA	player_C.J.-Brown	player_GWA
player_C.J.-Brown_HmA	player_C.J.-Brown	player_HmA
player_C.J.-Brown_RdA	player_C.J.-Brown	player_RdA
player_C.J.-Brown_A.90min	player_C.J.-Brown	player_A.90min
player_Chris-Albright_Club	player_Chris-Albright	player_Club
player_Chris-Albright_POS	player_Chris-Albright	player_POS
player_Chris-Albright_GP	player_Chris-Albright	player_GP
player_Chris-Albright_GS	player_Chris-Albright	player_GS
player_Chris-Albright_A	player_Chris-Albright	player_A
player_Chris-Albright_GWA	player_Chris-Albright	player_GWA
player_Chris-Albright_HmA	player_Chris-Albright	player_HmA
player_Chris-Albright_RdA	player_Chris-Albright	player_RdA
player_Chris-Albright_A.90min	player_Chris-Albright	player_A.90min
player_Chris-Houser_Club	player_Chris-Houser	player_Club
player_Chris-Houser_POS	player_Chris-Houser	player_POS
player_Chris-Houser_GP	player_Chris-Houser	player_GP
player_Chris-Houser_GS	player_Chris-Houser	player_GS
player_Chris-Houser_A	player_Chris-Houser	player_A
player_Chris-Houser_GWA	player_Chris-Houser	player_GWA
player_Chris-Houser_HmA	player_Chris-Houser	player_HmA
player_Chris-Houser_RdA	player_Chris-Houser	player_RdA
player_Chris-Houser_A.90min	player_Chris-Houser	player_A.90min
player_Brandon-Prideaux_Club	player_Brandon-Prideaux	player_Club
player_Brandon-Prideaux_POS	player_Brandon-Prideaux	player_POS
player_Brandon-Prideaux_GP	player_Brandon-Prideaux	player_GP
player_Brandon-Prideaux_GS	player_Brandon-Prideaux	player_GS
player_Brandon-Prideaux_A	player_Brandon-Prideaux	player_A
player_Brandon-Prideaux_GWA	player_Brandon-Prideaux	player_GWA
player_Brandon-Prideaux_HmA	player_Brandon-Prideaux	player_HmA
player_Brandon-Prideaux_RdA	player_Brandon-Prideaux	player_RdA
player_Brandon-Prideaux_A.90min	player_Brandon-Prideaux	player_A.90min
player_Mohammad-Khakpour_Club	player_Mohammad-Khakpour	player_Club
player_Mohammad-Khakpour_POS	player_Mohammad-Khakpour	player_POS
player_Mohammad-Khakpour_GP	player_Mohammad-Khakpour	player_GP
player_Mohammad-Khakpour_GS	player_Mohammad-Khakpour	player_GS
player_Mohammad-Khakpour_A	player_Mohammad-Khakpour	player_A
player_Mohammad-Khakpour_GWA	player_Mohammad-Khakpour	player_GWA
player_Mohammad-Khakpour_HmA	player_Mohammad-Khakpour	player_HmA
player_Mohammad-Khakpour_RdA	player_Mohammad-Khakpour	player_RdA
player_Mohammad-Khakpour_A.90min	player_Mohammad-Khakpour	player_A.90min
player_Jay-Heaps_Club	player_Jay-Heaps	player_Club
player_Jay-Heaps_POS	player_Jay-Heaps	player_POS
player_Jay-Heaps_GP	player_Jay-Heaps	player_GP
player_Jay-Heaps_GS	player_Jay-Heaps	player_GS
player_Jay-Heaps_A	player_Jay-Heaps	player_A
player_Jay-Heaps_GWA	player_Jay-Heaps	player_GWA
player_Jay-Heaps_HmA	player_Jay-Heaps	player_HmA
player_Jay-Heaps_RdA	player_Jay-Heaps	player_RdA
player_Jay-Heaps_A.90min	player_Jay-Heaps	player_A.90min
player_Andrew-Parrish_Club	player_Andrew-Parrish	player_Club
player_Andrew-Parrish_POS	player_Andrew-Parrish	player_POS
player_Andrew-Parrish_GP	player_Andrew-Parrish	player_GP
player_Andrew-Parrish_GS	player_Andrew-Parrish	player_GS
player_Andrew-Parrish_A	player_Andrew-Parrish	player_A
player_Andrew-Parrish_GWA	player_Andrew-Parrish	player_GWA
player_Andrew-Parrish_HmA	player_Andrew-Parrish	player_HmA
player_Andrew-Parrish_RdA	player_Andrew-Parrish	player_RdA
player_Andrew-Parrish_A.90min	player_Andrew-Parrish	player_A.90min
player_John-Rusek_Club	player_John-Rusek	player_Club
player_John-Rusek_POS	player_John-Rusek	player_POS
player_John-Rusek_GP	player_John-Rusek	player_GP
player_John-Rusek_GS	player_John-Rusek	player_GS
player_John-Rusek_A	player_John-Rusek	player_A
player_John-Rusek_GWA	player_John-Rusek	player_GWA
player_John-Rusek_HmA	player_John-Rusek	player_HmA
player_John-Rusek_RdA	player_John-Rusek	player_RdA
player_John-Rusek_A.90min	player_John-Rusek	player_A.90min
player_Ray-Goodlett_Club	player_Ray-Goodlett	player_Club
player_Ray-Goodlett_POS	player_Ray-Goodlett	player_POS
player_Ray-Goodlett_GP	player_Ray-Goodlett	player_GP
player_Ray-Goodlett_GS	player_Ray-Goodlett	player_GS
player_Ray-Goodlett_A	player_Ray-Goodlett	player_A
player_Ray-Goodlett_GWA	player_Ray-Goodlett	player_GWA
player_Ray-Goodlett_HmA	player_Ray-Goodlett	player_HmA
player_Ray-Goodlett_RdA	player_Ray-Goodlett	player_RdA
player_Ray-Goodlett_A.90min	player_Ray-Goodlett	player_A.90min
player_Michael-Green_Club	player_Michael-Green	player_Club
player_Michael-Green_POS	player_Michael-Green	player_POS
player_Michael-Green_GP	player_Michael-Green	player_GP
player_Michael-Green_GS	player_Michael-Green	player_GS
player_Michael-Green_A	player_Michael-Green	player_A
player_Michael-Green_GWA	player_Michael-Green	player_GWA
player_Michael-Green_HmA	player_Michael-Green	player_HmA
player_Michael-Green_RdA	player_Michael-Green	player_RdA
player_Michael-Green_A.90min	player_Michael-Green	player_A.90min
player_Evan-Whitfield_Club	player_Evan-Whitfield	player_Club
player_Evan-Whitfield_POS	player_Evan-Whitfield	player_POS
player_Evan-Whitfield_GP	player_Evan-Whitfield	player_GP
player_Evan-Whitfield_GS	player_Evan-Whitfield	player_GS
player_Evan-Whitfield_A	player_Evan-Whitfield	player_A
player_Evan-Whitfield_GWA	player_Evan-Whitfield	player_GWA
player_Evan-Whitfield_HmA	player_Evan-Whitfield	player_HmA
player_Evan-Whitfield_RdA	player_Evan-Whitfield	player_RdA
player_Evan-Whitfield_A.90min	player_Evan-Whitfield	player_A.90min
player_Manny-Motajo_Club	player_Manny-Motajo	player_Club
player_Manny-Motajo_POS	player_Manny-Motajo	player_POS
player_Manny-Motajo_GP	player_Manny-Motajo	player_GP
player_Manny-Motajo_GS	player_Manny-Motajo	player_GS
player_Manny-Motajo_A	player_Manny-Motajo	player_A
player_Manny-Motajo_GWA	player_Manny-Motajo	player_GWA
player_Manny-Motajo_HmA	player_Manny-Motajo	player_HmA
player_Manny-Motajo_RdA	player_Manny-Motajo	player_RdA
player_Manny-Motajo_A.90min	player_Manny-Motajo	player_A.90min
player_Chaka-Daley_Club	player_Chaka-Daley	player_Club
player_Chaka-Daley_POS	player_Chaka-Daley	player_POS
player_Chaka-Daley_GP	player_Chaka-Daley	player_GP
player_Chaka-Daley_GS	player_Chaka-Daley	player_GS
player_Chaka-Daley_A	player_Chaka-Daley	player_A
player_Chaka-Daley_GWA	player_Chaka-Daley	player_GWA
player_Chaka-Daley_HmA	player_Chaka-Daley	player_HmA
player_Chaka-Daley_RdA	player_Chaka-Daley	player_RdA
player_Chaka-Daley_A.90min	player_Chaka-Daley	player_A.90min
player_Tony-Soto_Club	player_Tony-Soto	player_Club
player_Tony-Soto_POS	player_Tony-Soto	player_POS
player_Tony-Soto_GP	player_Tony-Soto	player_GP
player_Tony-Soto_GS	player_Tony-Soto	player_GS
player_Tony-Soto_A	player_Tony-Soto	player_A
player_Tony-Soto_GWA	player_Tony-Soto	player_GWA
player_Tony-Soto_HmA	player_Tony-Soto	player_HmA
player_Tony-Soto_RdA	player_Tony-Soto	player_RdA
player_Tony-Soto_A.90min	player_Tony-Soto	player_A.90min
player_Matt-Chulis_Club	player_Matt-Chulis	player_Club
player_Matt-Chulis_POS	player_Matt-Chulis	player_POS
player_Matt-Chulis_GP	player_Matt-Chulis	player_GP
player_Matt-Chulis_GS	player_Matt-Chulis	player_GS
player_Matt-Chulis_A	player_Matt-Chulis	player_A
player_Matt-Chulis_GWA	player_Matt-Chulis	player_GWA
player_Matt-Chulis_HmA	player_Matt-Chulis	player_HmA
player_Matt-Chulis_RdA	player_Matt-Chulis	player_RdA
player_Matt-Chulis_A.90min	player_Matt-Chulis	player_A.90min
player_Joseph-Addo_Club	player_Joseph-Addo	player_Club
player_Joseph-Addo_POS	player_Joseph-Addo	player_POS
player_Joseph-Addo_GP	player_Joseph-Addo	player_GP
player_Joseph-Addo_GS	player_Joseph-Addo	player_GS
player_Joseph-Addo_A	player_Joseph-Addo	player_A
player_Joseph-Addo_GWA	player_Joseph-Addo	player_GWA
player_Joseph-Addo_HmA	player_Joseph-Addo	player_HmA
player_Joseph-Addo_RdA	player_Joseph-Addo	player_RdA
player_Joseph-Addo_A.90min	player_Joseph-Addo	player_A.90min
player_Ryan-Tinsley_Club	player_Ryan-Tinsley	player_Club
player_Ryan-Tinsley_POS	player_Ryan-Tinsley	player_POS
player_Ryan-Tinsley_GP	player_Ryan-Tinsley	player_GP
player_Ryan-Tinsley_GS	player_Ryan-Tinsley	player_GS
player_Ryan-Tinsley_A	player_Ryan-Tinsley	player_A
player_Ryan-Tinsley_GWA	player_Ryan-Tinsley	player_GWA
player_Ryan-Tinsley_HmA	player_Ryan-Tinsley	player_HmA
player_Ryan-Tinsley_RdA	player_Ryan-Tinsley	player_RdA
player_Ryan-Tinsley_A.90min	player_Ryan-Tinsley	player_A.90min
player_Kevin-Knight_Club	player_Kevin-Knight	player_Club
player_Kevin-Knight_POS	player_Kevin-Knight	player_POS
player_Kevin-Knight_GP	player_Kevin-Knight	player_GP
player_Kevin-Knight_GS	player_Kevin-Knight	player_GS
player_Kevin-Knight_A	player_Kevin-Knight	player_A
player_Kevin-Knight_GWA	player_Kevin-Knight	player_GWA
player_Kevin-Knight_HmA	player_Kevin-Knight	player_HmA
player_Kevin-Knight_RdA	player_Kevin-Knight	player_RdA
player_Kevin-Knight_A.90min	player_Kevin-Knight	player_A.90min
player_Richard-Goulooze_Club	player_Richard-Goulooze	player_Club
player_Richard-Goulooze_POS	player_Richard-Goulooze	player_POS
player_Richard-Goulooze_GP	player_Richard-Goulooze	player_GP
player_Richard-Goulooze_GS	player_Richard-Goulooze	player_GS
player_Richard-Goulooze_A	player_Richard-Goulooze	player_A
player_Richard-Goulooze_GWA	player_Richard-Goulooze	player_GWA
player_Richard-Goulooze_HmA	player_Richard-Goulooze	player_HmA
player_Richard-Goulooze_RdA	player_Richard-Goulooze	player_RdA
player_Richard-Goulooze_A.90min	player_Richard-Goulooze	player_A.90min
player_Vicente-Figueroa_Club	player_Vicente-Figueroa	player_Club
player_Vicente-Figueroa_POS	player_Vicente-Figueroa	player_POS
player_Vicente-Figueroa_GP	player_Vicente-Figueroa	player_GP
player_Vicente-Figueroa_GS	player_Vicente-Figueroa	player_GS
player_Vicente-Figueroa_A	player_Vicente-Figueroa	player_A
player_Vicente-Figueroa_GWA	player_Vicente-Figueroa	player_GWA
player_Vicente-Figueroa_HmA	player_Vicente-Figueroa	player_HmA
player_Vicente-Figueroa_RdA	player_Vicente-Figueroa	player_RdA
player_Vicente-Figueroa_A.90min	player_Vicente-Figueroa	player_A.90min
player_Jeremy-Aldrich_Club	player_Jeremy-Aldrich	player_Club
player_Jeremy-Aldrich_POS	player_Jeremy-Aldrich	player_POS
player_Jeremy-Aldrich_GP	player_Jeremy-Aldrich	player_GP
player_Jeremy-Aldrich_GS	player_Jeremy-Aldrich	player_GS
player_Jeremy-Aldrich_A	player_Jeremy-Aldrich	player_A
player_Jeremy-Aldrich_GWA	player_Jeremy-Aldrich	player_GWA
player_Jeremy-Aldrich_HmA	player_Jeremy-Aldrich	player_HmA
player_Jeremy-Aldrich_RdA	player_Jeremy-Aldrich	player_RdA
player_Jeremy-Aldrich_A.90min	player_Jeremy-Aldrich	player_A.90min
player_Dan-Calichman_Club	player_Dan-Calichman	player_Club
player_Dan-Calichman_POS	player_Dan-Calichman	player_POS
player_Dan-Calichman_GP	player_Dan-Calichman	player_GP
player_Dan-Calichman_GS	player_Dan-Calichman	player_GS
player_Dan-Calichman_A	player_Dan-Calichman	player_A
player_Dan-Calichman_GWA	player_Dan-Calichman	player_GWA
player_Dan-Calichman_HmA	player_Dan-Calichman	player_HmA
player_Dan-Calichman_RdA	player_Dan-Calichman	player_RdA
player_Dan-Calichman_A.90min	player_Dan-Calichman	player_A.90min
player_Micah-Cooks_Club	player_Micah-Cooks	player_Club
player_Micah-Cooks_POS	player_Micah-Cooks	player_POS
player_Micah-Cooks_GP	player_Micah-Cooks	player_GP
player_Micah-Cooks_GS	player_Micah-Cooks	player_GS
player_Micah-Cooks_A	player_Micah-Cooks	player_A
player_Micah-Cooks_GWA	player_Micah-Cooks	player_GWA
player_Micah-Cooks_HmA	player_Micah-Cooks	player_HmA
player_Micah-Cooks_RdA	player_Micah-Cooks	player_RdA
player_Micah-Cooks_A.90min	player_Micah-Cooks	player_A.90min
player_Eric-Denton_Club	player_Eric-Denton	player_Club
player_Eric-Denton_POS	player_Eric-Denton	player_POS
player_Eric-Denton_GP	player_Eric-Denton	player_GP
player_Eric-Denton_GS	player_Eric-Denton	player_GS
player_Eric-Denton_A	player_Eric-Denton	player_A
player_Eric-Denton_GWA	player_Eric-Denton	player_GWA
player_Eric-Denton_HmA	player_Eric-Denton	player_HmA
player_Eric-Denton_RdA	player_Eric-Denton	player_RdA
player_Eric-Denton_A.90min	player_Eric-Denton	player_A.90min
player_Steve-Shak_Club	player_Steve-Shak	player_Club
player_Steve-Shak_POS	player_Steve-Shak	player_POS
player_Steve-Shak_GP	player_Steve-Shak	player_GP
player_Steve-Shak_GS	player_Steve-Shak	player_GS
player_Steve-Shak_A	player_Steve-Shak	player_A
player_Steve-Shak_GWA	player_Steve-Shak	player_GWA
player_Steve-Shak_HmA	player_Steve-Shak	player_HmA
player_Steve-Shak_RdA	player_Steve-Shak	player_RdA
player_Steve-Shak_A.90min	player_Steve-Shak	player_A.90min
player_Carlos-Bocanegra_Club	player_Carlos-Bocanegra	player_Club
player_Carlos-Bocanegra_POS	player_Carlos-Bocanegra	player_POS
player_Carlos-Bocanegra_GP	player_Carlos-Bocanegra	player_GP
player_Carlos-Bocanegra_GS	player_Carlos-Bocanegra	player_GS
player_Carlos-Bocanegra_A	player_Carlos-Bocanegra	player_A
player_Carlos-Bocanegra_GWA	player_Carlos-Bocanegra	player_GWA
player_Carlos-Bocanegra_HmA	player_Carlos-Bocanegra	player_HmA
player_Carlos-Bocanegra_RdA	player_Carlos-Bocanegra	player_RdA
player_Carlos-Bocanegra_A.90min	player_Carlos-Bocanegra	player_A.90min
player_Mauricio-Wright_Club	player_Mauricio-Wright	player_Club
player_Mauricio-Wright_POS	player_Mauricio-Wright	player_POS
player_Mauricio-Wright_GP	player_Mauricio-Wright	player_GP
player_Mauricio-Wright_GS	player_Mauricio-Wright	player_GS
player_Mauricio-Wright_A	player_Mauricio-Wright	player_A
player_Mauricio-Wright_GWA	player_Mauricio-Wright	player_GWA
player_Mauricio-Wright_HmA	player_Mauricio-Wright	player_HmA
player_Mauricio-Wright_RdA	player_Mauricio-Wright	player_RdA
player_Mauricio-Wright_A.90min	player_Mauricio-Wright	player_A.90min
player_Carey-Talley_Club	player_Carey-Talley	player_Club
player_Carey-Talley_POS	player_Carey-Talley	player_POS
player_Carey-Talley_GP	player_Carey-Talley	player_GP
player_Carey-Talley_GS	player_Carey-Talley	player_GS
player_Carey-Talley_A	player_Carey-Talley	player_A
player_Carey-Talley_GWA	player_Carey-Talley	player_GWA
player_Carey-Talley_HmA	player_Carey-Talley	player_HmA
player_Carey-Talley_RdA	player_Carey-Talley	player_RdA
player_Carey-Talley_A.90min	player_Carey-Talley	player_A.90min
player_Steve-Trittschuh_Club	player_Steve-Trittschuh	player_Club
player_Steve-Trittschuh_POS	player_Steve-Trittschuh	player_POS
player_Steve-Trittschuh_GP	player_Steve-Trittschuh	player_GP
player_Steve-Trittschuh_GS	player_Steve-Trittschuh	player_GS
player_Steve-Trittschuh_A	player_Steve-Trittschuh	player_A
player_Steve-Trittschuh_GWA	player_Steve-Trittschuh	player_GWA
player_Steve-Trittschuh_HmA	player_Steve-Trittschuh	player_HmA
player_Steve-Trittschuh_RdA	player_Steve-Trittschuh	player_RdA
player_Steve-Trittschuh_A.90min	player_Steve-Trittschuh	player_A.90min
player_Steve-Bernal_Club	player_Steve-Bernal	player_Club
player_Steve-Bernal_POS	player_Steve-Bernal	player_POS
player_Steve-Bernal_GP	player_Steve-Bernal	player_GP
player_Steve-Bernal_GS	player_Steve-Bernal	player_GS
player_Steve-Bernal_A	player_Steve-Bernal	player_A
player_Steve-Bernal_GWA	player_Steve-Bernal	player_GWA
player_Steve-Bernal_HmA	player_Steve-Bernal	player_HmA
player_Steve-Bernal_RdA	player_Steve-Bernal	player_RdA
player_Steve-Bernal_A.90min	player_Steve-Bernal	player_A.90min
player_Tenywa-Bonseu_Club	player_Tenywa-Bonseu	player_Club
player_Tenywa-Bonseu_POS	player_Tenywa-Bonseu	player_POS
player_Tenywa-Bonseu_GP	player_Tenywa-Bonseu	player_GP
player_Tenywa-Bonseu_GS	player_Tenywa-Bonseu	player_GS
player_Tenywa-Bonseu_A	player_Tenywa-Bonseu	player_A
player_Tenywa-Bonseu_GWA	player_Tenywa-Bonseu	player_GWA
player_Tenywa-Bonseu_HmA	player_Tenywa-Bonseu	player_HmA
player_Tenywa-Bonseu_RdA	player_Tenywa-Bonseu	player_RdA
player_Tenywa-Bonseu_A.90min	player_Tenywa-Bonseu	player_A.90min
player_John-Wilson_Club	player_John-Wilson	player_Club
player_John-Wilson_POS	player_John-Wilson	player_POS
player_John-Wilson_GP	player_John-Wilson	player_GP
player_John-Wilson_GS	player_John-Wilson	player_GS
player_John-Wilson_A	player_John-Wilson	player_A
player_John-Wilson_GWA	player_John-Wilson	player_GWA
player_John-Wilson_HmA	player_John-Wilson	player_HmA
player_John-Wilson_RdA	player_John-Wilson	player_RdA
player_John-Wilson_A.90min	player_John-Wilson	player_A.90min
player_Dominic-Schell_Club	player_Dominic-Schell	player_Club
player_Dominic-Schell_POS	player_Dominic-Schell	player_POS
player_Dominic-Schell_GP	player_Dominic-Schell	player_GP
player_Dominic-Schell_GS	player_Dominic-Schell	player_GS
player_Dominic-Schell_A	player_Dominic-Schell	player_A
player_Dominic-Schell_GWA	player_Dominic-Schell	player_GWA
player_Dominic-Schell_HmA	player_Dominic-Schell	player_HmA
player_Dominic-Schell_RdA	player_Dominic-Schell	player_RdA
player_Dominic-Schell_A.90min	player_Dominic-Schell	player_A.90min
player_Chris-Jahr_Club	player_Chris-Jahr	player_Club
player_Chris-Jahr_POS	player_Chris-Jahr	player_POS
player_Chris-Jahr_GP	player_Chris-Jahr	player_GP
player_Chris-Jahr_GS	player_Chris-Jahr	player_GS
player_Chris-Jahr_A	player_Chris-Jahr	player_A
player_Chris-Jahr_GWA	player_Chris-Jahr	player_GWA
player_Chris-Jahr_HmA	player_Chris-Jahr	player_HmA
player_Chris-Jahr_RdA	player_Chris-Jahr	player_RdA
player_Chris-Jahr_A.90min	player_Chris-Jahr	player_A.90min
player_Miroslaw-Rzepa_Club	player_Miroslaw-Rzepa	player_Club
player_Miroslaw-Rzepa_POS	player_Miroslaw-Rzepa	player_POS
player_Miroslaw-Rzepa_GP	player_Miroslaw-Rzepa	player_GP
player_Miroslaw-Rzepa_GS	player_Miroslaw-Rzepa	player_GS
player_Miroslaw-Rzepa_A	player_Miroslaw-Rzepa	player_A
player_Miroslaw-Rzepa_GWA	player_Miroslaw-Rzepa	player_GWA
player_Miroslaw-Rzepa_HmA	player_Miroslaw-Rzepa	player_HmA
player_Miroslaw-Rzepa_RdA	player_Miroslaw-Rzepa	player_RdA
player_Miroslaw-Rzepa_A.90min	player_Miroslaw-Rzepa	player_A.90min
player_Orlando-Perez_Club	player_Orlando-Perez	player_Club
player_Orlando-Perez_POS	player_Orlando-Perez	player_POS
player_Orlando-Perez_GP	player_Orlando-Perez	player_GP
player_Orlando-Perez_GS	player_Orlando-Perez	player_GS
player_Orlando-Perez_A	player_Orlando-Perez	player_A
player_Orlando-Perez_GWA	player_Orlando-Perez	player_GWA
player_Orlando-Perez_HmA	player_Orlando-Perez	player_HmA
player_Orlando-Perez_RdA	player_Orlando-Perez	player_RdA
player_Orlando-Perez_A.90min	player_Orlando-Perez	player_A.90min
player_Tim-Sahaydak_Club	player_Tim-Sahaydak	player_Club
player_Tim-Sahaydak_POS	player_Tim-Sahaydak	player_POS
player_Tim-Sahaydak_GP	player_Tim-Sahaydak	player_GP
player_Tim-Sahaydak_GS	player_Tim-Sahaydak	player_GS
player_Tim-Sahaydak_A	player_Tim-Sahaydak	player_A
player_Tim-Sahaydak_GWA	player_Tim-Sahaydak	player_GWA
player_Tim-Sahaydak_HmA	player_Tim-Sahaydak	player_HmA
player_Tim-Sahaydak_RdA	player_Tim-Sahaydak	player_RdA
player_Tim-Sahaydak_A.90min	player_Tim-Sahaydak	player_A.90min
player_Adam-Eyre_Club	player_Adam-Eyre	player_Club
player_Adam-Eyre_POS	player_Adam-Eyre	player_POS
player_Adam-Eyre_GP	player_Adam-Eyre	player_GP
player_Adam-Eyre_GS	player_Adam-Eyre	player_GS
player_Adam-Eyre_A	player_Adam-Eyre	player_A
player_Adam-Eyre_GWA	player_Adam-Eyre	player_GWA
player_Adam-Eyre_HmA	player_Adam-Eyre	player_HmA
player_Adam-Eyre_RdA	player_Adam-Eyre	player_RdA
player_Adam-Eyre_A.90min	player_Adam-Eyre	player_A.90min
player_Kevin-Anderson_Club	player_Kevin-Anderson	player_Club
player_Kevin-Anderson_POS	player_Kevin-Anderson	player_POS
player_Kevin-Anderson_GP	player_Kevin-Anderson	player_GP
player_Kevin-Anderson_GS	player_Kevin-Anderson	player_GS
player_Kevin-Anderson_A	player_Kevin-Anderson	player_A
player_Kevin-Anderson_GWA	player_Kevin-Anderson	player_GWA
player_Kevin-Anderson_HmA	player_Kevin-Anderson	player_HmA
player_Kevin-Anderson_RdA	player_Kevin-Anderson	player_RdA
player_Kevin-Anderson_A.90min	player_Kevin-Anderson	player_A.90min
player_Jim-Curtin_Club	player_Jim-Curtin	player_Club
player_Jim-Curtin_POS	player_Jim-Curtin	player_POS
player_Jim-Curtin_GP	player_Jim-Curtin	player_GP
player_Jim-Curtin_GS	player_Jim-Curtin	player_GS
player_Jim-Curtin_A	player_Jim-Curtin	player_A
player_Jim-Curtin_GWA	player_Jim-Curtin	player_GWA
player_Jim-Curtin_HmA	player_Jim-Curtin	player_HmA
player_Jim-Curtin_RdA	player_Jim-Curtin	player_RdA
player_Jim-Curtin_A.90min	player_Jim-Curtin	player_A.90min
player_Duncan-Oughton_Club	player_Duncan-Oughton	player_Club
player_Duncan-Oughton_POS	player_Duncan-Oughton	player_POS
player_Duncan-Oughton_GP	player_Duncan-Oughton	player_GP
player_Duncan-Oughton_GS	player_Duncan-Oughton	player_GS
player_Duncan-Oughton_A	player_Duncan-Oughton	player_A
player_Duncan-Oughton_GWA	player_Duncan-Oughton	player_GWA
player_Duncan-Oughton_HmA	player_Duncan-Oughton	player_HmA
player_Duncan-Oughton_RdA	player_Duncan-Oughton	player_RdA
player_Duncan-Oughton_A.90min	player_Duncan-Oughton	player_A.90min
player_Craig-Demmin_Club	player_Craig-Demmin	player_Club
player_Craig-Demmin_POS	player_Craig-Demmin	player_POS
player_Craig-Demmin_GP	player_Craig-Demmin	player_GP
player_Craig-Demmin_GS	player_Craig-Demmin	player_GS
player_Craig-Demmin_A	player_Craig-Demmin	player_A
player_Craig-Demmin_GWA	player_Craig-Demmin	player_GWA
player_Craig-Demmin_HmA	player_Craig-Demmin	player_HmA
player_Craig-Demmin_RdA	player_Craig-Demmin	player_RdA
player_Craig-Demmin_A.90min	player_Craig-Demmin	player_A.90min
player_Jeff-Rigby_Club	player_Jeff-Rigby	player_Club
player_Jeff-Rigby_POS	player_Jeff-Rigby	player_POS
player_Jeff-Rigby_GP	player_Jeff-Rigby	player_GP
player_Jeff-Rigby_GS	player_Jeff-Rigby	player_GS
player_Jeff-Rigby_A	player_Jeff-Rigby	player_A
player_Jeff-Rigby_GWA	player_Jeff-Rigby	player_GWA
player_Jeff-Rigby_HmA	player_Jeff-Rigby	player_HmA
player_Jeff-Rigby_RdA	player_Jeff-Rigby	player_RdA
player_Jeff-Rigby_A.90min	player_Jeff-Rigby	player_A.90min
player_Stephen-Danbusky_Club	player_Stephen-Danbusky	player_Club
player_Stephen-Danbusky_POS	player_Stephen-Danbusky	player_POS
player_Stephen-Danbusky_GP	player_Stephen-Danbusky	player_GP
player_Stephen-Danbusky_GS	player_Stephen-Danbusky	player_GS
player_Stephen-Danbusky_A	player_Stephen-Danbusky	player_A
player_Stephen-Danbusky_GWA	player_Stephen-Danbusky	player_GWA
player_Stephen-Danbusky_HmA	player_Stephen-Danbusky	player_HmA
player_Stephen-Danbusky_RdA	player_Stephen-Danbusky	player_RdA
player_Stephen-Danbusky_A.90min	player_Stephen-Danbusky	player_A.90min
player_Fred-DeGand_Club	player_Fred-DeGand	player_Club
player_Fred-DeGand_POS	player_Fred-DeGand	player_POS
player_Fred-DeGand_GP	player_Fred-DeGand	player_GP
player_Fred-DeGand_GS	player_Fred-DeGand	player_GS
player_Fred-DeGand_A	player_Fred-DeGand	player_A
player_Fred-DeGand_GWA	player_Fred-DeGand	player_GWA
player_Fred-DeGand_HmA	player_Fred-DeGand	player_HmA
player_Fred-DeGand_RdA	player_Fred-DeGand	player_RdA
player_Fred-DeGand_A.90min	player_Fred-DeGand	player_A.90min
player_Don-Gramenz_Club	player_Don-Gramenz	player_Club
player_Don-Gramenz_POS	player_Don-Gramenz	player_POS
player_Don-Gramenz_GP	player_Don-Gramenz	player_GP
player_Don-Gramenz_GS	player_Don-Gramenz	player_GS
player_Don-Gramenz_A	player_Don-Gramenz	player_A
player_Don-Gramenz_GWA	player_Don-Gramenz	player_GWA
player_Don-Gramenz_HmA	player_Don-Gramenz	player_HmA
player_Don-Gramenz_RdA	player_Don-Gramenz	player_RdA
player_Don-Gramenz_A.90min	player_Don-Gramenz	player_A.90min
player_Chad-Prince_Club	player_Chad-Prince	player_Club
player_Chad-Prince_POS	player_Chad-Prince	player_POS
player_Chad-Prince_GP	player_Chad-Prince	player_GP
player_Chad-Prince_GS	player_Chad-Prince	player_GS
player_Chad-Prince_A	player_Chad-Prince	player_A
player_Chad-Prince_GWA	player_Chad-Prince	player_GWA
player_Chad-Prince_HmA	player_Chad-Prince	player_HmA
player_Chad-Prince_RdA	player_Chad-Prince	player_RdA
player_Chad-Prince_A.90min	player_Chad-Prince	player_A.90min
player_Randy-Merkel_Club	player_Randy-Merkel	player_Club
player_Randy-Merkel_POS	player_Randy-Merkel	player_POS
player_Randy-Merkel_GP	player_Randy-Merkel	player_GP
player_Randy-Merkel_GS	player_Randy-Merkel	player_GS
player_Randy-Merkel_A	player_Randy-Merkel	player_A
player_Randy-Merkel_GWA	player_Randy-Merkel	player_GWA
player_Randy-Merkel_HmA	player_Randy-Merkel	player_HmA
player_Randy-Merkel_RdA	player_Randy-Merkel	player_RdA
player_Randy-Merkel_A.90min	player_Randy-Merkel	player_A.90min
player_Mersim-Beskovic_Club	player_Mersim-Beskovic	player_Club
player_Mersim-Beskovic_POS	player_Mersim-Beskovic	player_POS
player_Mersim-Beskovic_GP	player_Mersim-Beskovic	player_GP
player_Mersim-Beskovic_GS	player_Mersim-Beskovic	player_GS
player_Mersim-Beskovic_A	player_Mersim-Beskovic	player_A
player_Mersim-Beskovic_GWA	player_Mersim-Beskovic	player_GWA
player_Mersim-Beskovic_HmA	player_Mersim-Beskovic	player_HmA
player_Mersim-Beskovic_RdA	player_Mersim-Beskovic	player_RdA
player_Mersim-Beskovic_A.90min	player_Mersim-Beskovic	player_A.90min
player_Fausto-Klinger_Club	player_Fausto-Klinger	player_Club
player_Fausto-Klinger_POS	player_Fausto-Klinger	player_POS
player_Fausto-Klinger_GP	player_Fausto-Klinger	player_GP
player_Fausto-Klinger_GS	player_Fausto-Klinger	player_GS
player_Fausto-Klinger_A	player_Fausto-Klinger	player_A
player_Fausto-Klinger_GWA	player_Fausto-Klinger	player_GWA
player_Fausto-Klinger_HmA	player_Fausto-Klinger	player_HmA
player_Fausto-Klinger_RdA	player_Fausto-Klinger	player_RdA
player_Fausto-Klinger_A.90min	player_Fausto-Klinger	player_A.90min
player_Josue-Mayard_Club	player_Josue-Mayard	player_Club
player_Josue-Mayard_POS	player_Josue-Mayard	player_POS
player_Josue-Mayard_GP	player_Josue-Mayard	player_GP
player_Josue-Mayard_GS	player_Josue-Mayard	player_GS
player_Josue-Mayard_A	player_Josue-Mayard	player_A
player_Josue-Mayard_GWA	player_Josue-Mayard	player_GWA
player_Josue-Mayard_HmA	player_Josue-Mayard	player_HmA
player_Josue-Mayard_RdA	player_Josue-Mayard	player_RdA
player_Josue-Mayard_A.90min	player_Josue-Mayard	player_A.90min
player_Kevin-Adams_Club	player_Kevin-Adams	player_Club
player_Kevin-Adams_POS	player_Kevin-Adams	player_POS
player_Kevin-Adams_GP	player_Kevin-Adams	player_GP
player_Kevin-Adams_GS	player_Kevin-Adams	player_GS
player_Kevin-Adams_A	player_Kevin-Adams	player_A
player_Kevin-Adams_GWA	player_Kevin-Adams	player_GWA
player_Kevin-Adams_HmA	player_Kevin-Adams	player_HmA
player_Kevin-Adams_RdA	player_Kevin-Adams	player_RdA
player_Kevin-Adams_A.90min	player_Kevin-Adams	player_A.90min
player_Jose-Burciaga-Jr._Club	player_Jose-Burciaga-Jr.	player_Club
player_Jose-Burciaga-Jr._POS	player_Jose-Burciaga-Jr.	player_POS
player_Jose-Burciaga-Jr._GP	player_Jose-Burciaga-Jr.	player_GP
player_Jose-Burciaga-Jr._GS	player_Jose-Burciaga-Jr.	player_GS
player_Jose-Burciaga-Jr._A	player_Jose-Burciaga-Jr.	player_A
player_Jose-Burciaga-Jr._GWA	player_Jose-Burciaga-Jr.	player_GWA
player_Jose-Burciaga-Jr._HmA	player_Jose-Burciaga-Jr.	player_HmA
player_Jose-Burciaga-Jr._RdA	player_Jose-Burciaga-Jr.	player_RdA
player_Jose-Burciaga-Jr._A.90min	player_Jose-Burciaga-Jr.	player_A.90min
player_Nick-Downing_Club	player_Nick-Downing	player_Club
player_Nick-Downing_POS	player_Nick-Downing	player_POS
player_Nick-Downing_GP	player_Nick-Downing	player_GP
player_Nick-Downing_GS	player_Nick-Downing	player_GS
player_Nick-Downing_A	player_Nick-Downing	player_A
player_Nick-Downing_GWA	player_Nick-Downing	player_GWA
player_Nick-Downing_HmA	player_Nick-Downing	player_HmA
player_Nick-Downing_RdA	player_Nick-Downing	player_RdA
player_Nick-Downing_A.90min	player_Nick-Downing	player_A.90min
player_Diego-Sonora_Club	player_Diego-Sonora	player_Club
player_Diego-Sonora_POS	player_Diego-Sonora	player_POS
player_Diego-Sonora_GP	player_Diego-Sonora	player_GP
player_Diego-Sonora_GS	player_Diego-Sonora	player_GS
player_Diego-Sonora_A	player_Diego-Sonora	player_A
player_Diego-Sonora_GWA	player_Diego-Sonora	player_GWA
player_Diego-Sonora_HmA	player_Diego-Sonora	player_HmA
player_Diego-Sonora_RdA	player_Diego-Sonora	player_RdA
player_Diego-Sonora_A.90min	player_Diego-Sonora	player_A.90min
player_Tahj-Jakins_Club	player_Tahj-Jakins	player_Club
player_Tahj-Jakins_POS	player_Tahj-Jakins	player_POS
player_Tahj-Jakins_GP	player_Tahj-Jakins	player_GP
player_Tahj-Jakins_GS	player_Tahj-Jakins	player_GS
player_Tahj-Jakins_A	player_Tahj-Jakins	player_A
player_Tahj-Jakins_GWA	player_Tahj-Jakins	player_GWA
player_Tahj-Jakins_HmA	player_Tahj-Jakins	player_HmA
player_Tahj-Jakins_RdA	player_Tahj-Jakins	player_RdA
player_Tahj-Jakins_A.90min	player_Tahj-Jakins	player_A.90min
player_Scott-Cannon_Club	player_Scott-Cannon	player_Club
player_Scott-Cannon_POS	player_Scott-Cannon	player_POS
player_Scott-Cannon_GP	player_Scott-Cannon	player_GP
player_Scott-Cannon_GS	player_Scott-Cannon	player_GS
player_Scott-Cannon_A	player_Scott-Cannon	player_A
player_Scott-Cannon_GWA	player_Scott-Cannon	player_GWA
player_Scott-Cannon_HmA	player_Scott-Cannon	player_HmA
player_Scott-Cannon_RdA	player_Scott-Cannon	player_RdA
player_Scott-Cannon_A.90min	player_Scott-Cannon	player_A.90min
player_Alan-Woods_Club	player_Alan-Woods	player_Club
player_Alan-Woods_POS	player_Alan-Woods	player_POS
player_Alan-Woods_GP	player_Alan-Woods	player_GP
player_Alan-Woods_GS	player_Alan-Woods	player_GS
player_Alan-Woods_A	player_Alan-Woods	player_A
player_Alan-Woods_GWA	player_Alan-Woods	player_GWA
player_Alan-Woods_HmA	player_Alan-Woods	player_HmA
player_Alan-Woods_RdA	player_Alan-Woods	player_RdA
player_Alan-Woods_A.90min	player_Alan-Woods	player_A.90min
player_Rusty-Pierce_Club	player_Rusty-Pierce	player_Club
player_Rusty-Pierce_POS	player_Rusty-Pierce	player_POS
player_Rusty-Pierce_GP	player_Rusty-Pierce	player_GP
player_Rusty-Pierce_GS	player_Rusty-Pierce	player_GS
player_Rusty-Pierce_A	player_Rusty-Pierce	player_A
player_Rusty-Pierce_GWA	player_Rusty-Pierce	player_GWA
player_Rusty-Pierce_HmA	player_Rusty-Pierce	player_HmA
player_Rusty-Pierce_RdA	player_Rusty-Pierce	player_RdA
player_Rusty-Pierce_A.90min	player_Rusty-Pierce	player_A.90min
player_Nick-Garcia_Club	player_Nick-Garcia	player_Club
player_Nick-Garcia_POS	player_Nick-Garcia	player_POS
player_Nick-Garcia_GP	player_Nick-Garcia	player_GP
player_Nick-Garcia_GS	player_Nick-Garcia	player_GS
player_Nick-Garcia_A	player_Nick-Garcia	player_A
player_Nick-Garcia_GWA	player_Nick-Garcia	player_GWA
player_Nick-Garcia_HmA	player_Nick-Garcia	player_HmA
player_Nick-Garcia_RdA	player_Nick-Garcia	player_RdA
player_Nick-Garcia_A.90min	player_Nick-Garcia	player_A.90min
player_Carlos-Semedo_Club	player_Carlos-Semedo	player_Club
player_Carlos-Semedo_POS	player_Carlos-Semedo	player_POS
player_Carlos-Semedo_GP	player_Carlos-Semedo	player_GP
player_Carlos-Semedo_GS	player_Carlos-Semedo	player_GS
player_Carlos-Semedo_A	player_Carlos-Semedo	player_A
player_Carlos-Semedo_GWA	player_Carlos-Semedo	player_GWA
player_Carlos-Semedo_HmA	player_Carlos-Semedo	player_HmA
player_Carlos-Semedo_RdA	player_Carlos-Semedo	player_RdA
player_Carlos-Semedo_A.90min	player_Carlos-Semedo	player_A.90min
player_Billy-Sleeth_Club	player_Billy-Sleeth	player_Club
player_Billy-Sleeth_POS	player_Billy-Sleeth	player_POS
player_Billy-Sleeth_GP	player_Billy-Sleeth	player_GP
player_Billy-Sleeth_GS	player_Billy-Sleeth	player_GS
player_Billy-Sleeth_A	player_Billy-Sleeth	player_A
player_Billy-Sleeth_GWA	player_Billy-Sleeth	player_GWA
player_Billy-Sleeth_HmA	player_Billy-Sleeth	player_HmA
player_Billy-Sleeth_RdA	player_Billy-Sleeth	player_RdA
player_Billy-Sleeth_A.90min	player_Billy-Sleeth	player_A.90min
player_Daniel-Torres_Club	player_Daniel-Torres	player_Club
player_Daniel-Torres_POS	player_Daniel-Torres	player_POS
player_Daniel-Torres_GP	player_Daniel-Torres	player_GP
player_Daniel-Torres_GS	player_Daniel-Torres	player_GS
player_Daniel-Torres_A	player_Daniel-Torres	player_A
player_Daniel-Torres_GWA	player_Daniel-Torres	player_GWA
player_Daniel-Torres_HmA	player_Daniel-Torres	player_HmA
player_Daniel-Torres_RdA	player_Daniel-Torres	player_RdA
player_Daniel-Torres_A.90min	player_Daniel-Torres	player_A.90min
player_Steve-Jolley_Club	player_Steve-Jolley	player_Club
player_Steve-Jolley_POS	player_Steve-Jolley	player_POS
player_Steve-Jolley_GP	player_Steve-Jolley	player_GP
player_Steve-Jolley_GS	player_Steve-Jolley	player_GS
player_Steve-Jolley_A	player_Steve-Jolley	player_A
player_Steve-Jolley_GWA	player_Steve-Jolley	player_GWA
player_Steve-Jolley_HmA	player_Steve-Jolley	player_HmA
player_Steve-Jolley_RdA	player_Steve-Jolley	player_RdA
player_Steve-Jolley_A.90min	player_Steve-Jolley	player_A.90min
player_Leo-Krupnik_Club	player_Leo-Krupnik	player_Club
player_Leo-Krupnik_POS	player_Leo-Krupnik	player_POS
player_Leo-Krupnik_GP	player_Leo-Krupnik	player_GP
player_Leo-Krupnik_GS	player_Leo-Krupnik	player_GS
player_Leo-Krupnik_A	player_Leo-Krupnik	player_A
player_Leo-Krupnik_GWA	player_Leo-Krupnik	player_GWA
player_Leo-Krupnik_HmA	player_Leo-Krupnik	player_HmA
player_Leo-Krupnik_RdA	player_Leo-Krupnik	player_RdA
player_Leo-Krupnik_A.90min	player_Leo-Krupnik	player_A.90min
player_Marcelo-Balboa_Club	player_Marcelo-Balboa	player_Club
player_Marcelo-Balboa_POS	player_Marcelo-Balboa	player_POS
player_Marcelo-Balboa_GP	player_Marcelo-Balboa	player_GP
player_Marcelo-Balboa_GS	player_Marcelo-Balboa	player_GS
player_Marcelo-Balboa_A	player_Marcelo-Balboa	player_A
player_Marcelo-Balboa_GWA	player_Marcelo-Balboa	player_GWA
player_Marcelo-Balboa_HmA	player_Marcelo-Balboa	player_HmA
player_Marcelo-Balboa_RdA	player_Marcelo-Balboa	player_RdA
player_Marcelo-Balboa_A.90min	player_Marcelo-Balboa	player_A.90min
player_Lee-Morrison_Club	player_Lee-Morrison	player_Club
player_Lee-Morrison_POS	player_Lee-Morrison	player_POS
player_Lee-Morrison_GP	player_Lee-Morrison	player_GP
player_Lee-Morrison_GS	player_Lee-Morrison	player_GS
player_Lee-Morrison_A	player_Lee-Morrison	player_A
player_Lee-Morrison_GWA	player_Lee-Morrison	player_GWA
player_Lee-Morrison_HmA	player_Lee-Morrison	player_HmA
player_Lee-Morrison_RdA	player_Lee-Morrison	player_RdA
player_Lee-Morrison_A.90min	player_Lee-Morrison	player_A.90min
player_Chris-Brunt_Club	player_Chris-Brunt	player_Club
player_Chris-Brunt_POS	player_Chris-Brunt	player_POS
player_Chris-Brunt_GP	player_Chris-Brunt	player_GP
player_Chris-Brunt_GS	player_Chris-Brunt	player_GS
player_Chris-Brunt_A	player_Chris-Brunt	player_A
player_Chris-Brunt_GWA	player_Chris-Brunt	player_GWA
player_Chris-Brunt_HmA	player_Chris-Brunt	player_HmA
player_Chris-Brunt_RdA	player_Chris-Brunt	player_RdA
player_Chris-Brunt_A.90min	player_Chris-Brunt	player_A.90min
player_Matt-Behncke_Club	player_Matt-Behncke	player_Club
player_Matt-Behncke_POS	player_Matt-Behncke	player_POS
player_Matt-Behncke_GP	player_Matt-Behncke	player_GP
player_Matt-Behncke_GS	player_Matt-Behncke	player_GS
player_Matt-Behncke_A	player_Matt-Behncke	player_A
player_Matt-Behncke_GWA	player_Matt-Behncke	player_GWA
player_Matt-Behncke_HmA	player_Matt-Behncke	player_HmA
player_Matt-Behncke_RdA	player_Matt-Behncke	player_RdA
player_Matt-Behncke_A.90min	player_Matt-Behncke	player_A.90min
player_Nelson-Akwari_Club	player_Nelson-Akwari	player_Club
player_Nelson-Akwari_POS	player_Nelson-Akwari	player_POS
player_Nelson-Akwari_GP	player_Nelson-Akwari	player_GP
player_Nelson-Akwari_GS	player_Nelson-Akwari	player_GS
player_Nelson-Akwari_A	player_Nelson-Akwari	player_A
player_Nelson-Akwari_GWA	player_Nelson-Akwari	player_GWA
player_Nelson-Akwari_HmA	player_Nelson-Akwari	player_HmA
player_Nelson-Akwari_RdA	player_Nelson-Akwari	player_RdA
player_Nelson-Akwari_A.90min	player_Nelson-Akwari	player_A.90min
player_Sam-Forko_Club	player_Sam-Forko	player_Club
player_Sam-Forko_POS	player_Sam-Forko	player_POS
player_Sam-Forko_GP	player_Sam-Forko	player_GP
player_Sam-Forko_GS	player_Sam-Forko	player_GS
player_Sam-Forko_A	player_Sam-Forko	player_A
player_Sam-Forko_GWA	player_Sam-Forko	player_GWA
player_Sam-Forko_HmA	player_Sam-Forko	player_HmA
player_Sam-Forko_RdA	player_Sam-Forko	player_RdA
player_Sam-Forko_A.90min	player_Sam-Forko	player_A.90min
player_Bryan-Namoff_Club	player_Bryan-Namoff	player_Club
player_Bryan-Namoff_POS	player_Bryan-Namoff	player_POS
player_Bryan-Namoff_GP	player_Bryan-Namoff	player_GP
player_Bryan-Namoff_GS	player_Bryan-Namoff	player_GS
player_Bryan-Namoff_A	player_Bryan-Namoff	player_A
player_Bryan-Namoff_GWA	player_Bryan-Namoff	player_GWA
player_Bryan-Namoff_HmA	player_Bryan-Namoff	player_HmA
player_Bryan-Namoff_RdA	player_Bryan-Namoff	player_RdA
player_Bryan-Namoff_A.90min	player_Bryan-Namoff	player_A.90min
player_Daouda-Kante_Club	player_Daouda-Kante	player_Club
player_Daouda-Kante_POS	player_Daouda-Kante	player_POS
player_Daouda-Kante_GP	player_Daouda-Kante	player_GP
player_Daouda-Kante_GS	player_Daouda-Kante	player_GS
player_Daouda-Kante_A	player_Daouda-Kante	player_A
player_Daouda-Kante_GWA	player_Daouda-Kante	player_GWA
player_Daouda-Kante_HmA	player_Daouda-Kante	player_HmA
player_Daouda-Kante_RdA	player_Daouda-Kante	player_RdA
player_Daouda-Kante_A.90min	player_Daouda-Kante	player_A.90min
player_Chris-Leitch_Club	player_Chris-Leitch	player_Club
player_Chris-Leitch_POS	player_Chris-Leitch	player_POS
player_Chris-Leitch_GP	player_Chris-Leitch	player_GP
player_Chris-Leitch_GS	player_Chris-Leitch	player_GS
player_Chris-Leitch_A	player_Chris-Leitch	player_A
player_Chris-Leitch_GWA	player_Chris-Leitch	player_GWA
player_Chris-Leitch_HmA	player_Chris-Leitch	player_HmA
player_Chris-Leitch_RdA	player_Chris-Leitch	player_RdA
player_Chris-Leitch_A.90min	player_Chris-Leitch	player_A.90min
player_Craig-Ziadie_Club	player_Craig-Ziadie	player_Club
player_Craig-Ziadie_POS	player_Craig-Ziadie	player_POS
player_Craig-Ziadie_GP	player_Craig-Ziadie	player_GP
player_Craig-Ziadie_GS	player_Craig-Ziadie	player_GS
player_Craig-Ziadie_A	player_Craig-Ziadie	player_A
player_Craig-Ziadie_GWA	player_Craig-Ziadie	player_GWA
player_Craig-Ziadie_HmA	player_Craig-Ziadie	player_HmA
player_Craig-Ziadie_RdA	player_Craig-Ziadie	player_RdA
player_Craig-Ziadie_A.90min	player_Craig-Ziadie	player_A.90min
player_Steve-Morrow_Club	player_Steve-Morrow	player_Club
player_Steve-Morrow_POS	player_Steve-Morrow	player_POS
player_Steve-Morrow_GP	player_Steve-Morrow	player_GP
player_Steve-Morrow_GS	player_Steve-Morrow	player_GS
player_Steve-Morrow_A	player_Steve-Morrow	player_A
player_Steve-Morrow_GWA	player_Steve-Morrow	player_GWA
player_Steve-Morrow_HmA	player_Steve-Morrow	player_HmA
player_Steve-Morrow_RdA	player_Steve-Morrow	player_RdA
player_Steve-Morrow_A.90min	player_Steve-Morrow	player_A.90min
player_Kelly-Gray_Club	player_Kelly-Gray	player_Club
player_Kelly-Gray_POS	player_Kelly-Gray	player_POS
player_Kelly-Gray_GP	player_Kelly-Gray	player_GP
player_Kelly-Gray_GS	player_Kelly-Gray	player_GS
player_Kelly-Gray_A	player_Kelly-Gray	player_A
player_Kelly-Gray_GWA	player_Kelly-Gray	player_GWA
player_Kelly-Gray_HmA	player_Kelly-Gray	player_HmA
player_Kelly-Gray_RdA	player_Kelly-Gray	player_RdA
player_Kelly-Gray_A.90min	player_Kelly-Gray	player_A.90min
player_Galin-Ivanov_Club	player_Galin-Ivanov	player_Club
player_Galin-Ivanov_POS	player_Galin-Ivanov	player_POS
player_Galin-Ivanov_GP	player_Galin-Ivanov	player_GP
player_Galin-Ivanov_GS	player_Galin-Ivanov	player_GS
player_Galin-Ivanov_A	player_Galin-Ivanov	player_A
player_Galin-Ivanov_GWA	player_Galin-Ivanov	player_GWA
player_Galin-Ivanov_HmA	player_Galin-Ivanov	player_HmA
player_Galin-Ivanov_RdA	player_Galin-Ivanov	player_RdA
player_Galin-Ivanov_A.90min	player_Galin-Ivanov	player_A.90min
player_Ezra-Hendrickson_Club	player_Ezra-Hendrickson	player_Club
player_Ezra-Hendrickson_POS	player_Ezra-Hendrickson	player_POS
player_Ezra-Hendrickson_GP	player_Ezra-Hendrickson	player_GP
player_Ezra-Hendrickson_GS	player_Ezra-Hendrickson	player_GS
player_Ezra-Hendrickson_A	player_Ezra-Hendrickson	player_A
player_Ezra-Hendrickson_GWA	player_Ezra-Hendrickson	player_GWA
player_Ezra-Hendrickson_HmA	player_Ezra-Hendrickson	player_HmA
player_Ezra-Hendrickson_RdA	player_Ezra-Hendrickson	player_RdA
player_Ezra-Hendrickson_A.90min	player_Ezra-Hendrickson	player_A.90min
player_Jimmy-Conrad_Club	player_Jimmy-Conrad	player_Club
player_Jimmy-Conrad_POS	player_Jimmy-Conrad	player_POS
player_Jimmy-Conrad_GP	player_Jimmy-Conrad	player_GP
player_Jimmy-Conrad_GS	player_Jimmy-Conrad	player_GS
player_Jimmy-Conrad_A	player_Jimmy-Conrad	player_A
player_Jimmy-Conrad_GWA	player_Jimmy-Conrad	player_GWA
player_Jimmy-Conrad_HmA	player_Jimmy-Conrad	player_HmA
player_Jimmy-Conrad_RdA	player_Jimmy-Conrad	player_RdA
player_Jimmy-Conrad_A.90min	player_Jimmy-Conrad	player_A.90min
player_Tim-Glowienka_Club	player_Tim-Glowienka	player_Club
player_Tim-Glowienka_POS	player_Tim-Glowienka	player_POS
player_Tim-Glowienka_GP	player_Tim-Glowienka	player_GP
player_Tim-Glowienka_GS	player_Tim-Glowienka	player_GS
player_Tim-Glowienka_A	player_Tim-Glowienka	player_A
player_Tim-Glowienka_GWA	player_Tim-Glowienka	player_GWA
player_Tim-Glowienka_HmA	player_Tim-Glowienka	player_HmA
player_Tim-Glowienka_RdA	player_Tim-Glowienka	player_RdA
player_Tim-Glowienka_A.90min	player_Tim-Glowienka	player_A.90min
player_Kevin-Friedland_Club	player_Kevin-Friedland	player_Club
player_Kevin-Friedland_POS	player_Kevin-Friedland	player_POS
player_Kevin-Friedland_GP	player_Kevin-Friedland	player_GP
player_Kevin-Friedland_GS	player_Kevin-Friedland	player_GS
player_Kevin-Friedland_A	player_Kevin-Friedland	player_A
player_Kevin-Friedland_GWA	player_Kevin-Friedland	player_GWA
player_Kevin-Friedland_HmA	player_Kevin-Friedland	player_HmA
player_Kevin-Friedland_RdA	player_Kevin-Friedland	player_RdA
player_Kevin-Friedland_A.90min	player_Kevin-Friedland	player_A.90min
player_David-Stokes_Club	player_David-Stokes	player_Club
player_David-Stokes_POS	player_David-Stokes	player_POS
player_David-Stokes_GP	player_David-Stokes	player_GP
player_David-Stokes_GS	player_David-Stokes	player_GS
player_David-Stokes_A	player_David-Stokes	player_A
player_David-Stokes_GWA	player_David-Stokes	player_GWA
player_David-Stokes_HmA	player_David-Stokes	player_HmA
player_David-Stokes_RdA	player_David-Stokes	player_RdA
player_David-Stokes_A.90min	player_David-Stokes	player_A.90min
player_Taylor-Graham_Club	player_Taylor-Graham	player_Club
player_Taylor-Graham_POS	player_Taylor-Graham	player_POS
player_Taylor-Graham_GP	player_Taylor-Graham	player_GP
player_Taylor-Graham_GS	player_Taylor-Graham	player_GS
player_Taylor-Graham_A	player_Taylor-Graham	player_A
player_Taylor-Graham_GWA	player_Taylor-Graham	player_GWA
player_Taylor-Graham_HmA	player_Taylor-Graham	player_HmA
player_Taylor-Graham_RdA	player_Taylor-Graham	player_RdA
player_Taylor-Graham_A.90min	player_Taylor-Graham	player_A.90min
player_Mark-Williams_Club	player_Mark-Williams	player_Club
player_Mark-Williams_POS	player_Mark-Williams	player_POS
player_Mark-Williams_GP	player_Mark-Williams	player_GP
player_Mark-Williams_GS	player_Mark-Williams	player_GS
player_Mark-Williams_A	player_Mark-Williams	player_A
player_Mark-Williams_GWA	player_Mark-Williams	player_GWA
player_Mark-Williams_HmA	player_Mark-Williams	player_HmA
player_Mark-Williams_RdA	player_Mark-Williams	player_RdA
player_Mark-Williams_A.90min	player_Mark-Williams	player_A.90min
player_Kenny-Arena_Club	player_Kenny-Arena	player_Club
player_Kenny-Arena_POS	player_Kenny-Arena	player_POS
player_Kenny-Arena_GP	player_Kenny-Arena	player_GP
player_Kenny-Arena_GS	player_Kenny-Arena	player_GS
player_Kenny-Arena_A	player_Kenny-Arena	player_A
player_Kenny-Arena_GWA	player_Kenny-Arena	player_GWA
player_Kenny-Arena_HmA	player_Kenny-Arena	player_HmA
player_Kenny-Arena_RdA	player_Kenny-Arena	player_RdA
player_Kenny-Arena_A.90min	player_Kenny-Arena	player_A.90min
player_Philip-Salyer_Club	player_Philip-Salyer	player_Club
player_Philip-Salyer_POS	player_Philip-Salyer	player_POS
player_Philip-Salyer_GP	player_Philip-Salyer	player_GP
player_Philip-Salyer_GS	player_Philip-Salyer	player_GS
player_Philip-Salyer_A	player_Philip-Salyer	player_A
player_Philip-Salyer_GWA	player_Philip-Salyer	player_GWA
player_Philip-Salyer_HmA	player_Philip-Salyer	player_HmA
player_Philip-Salyer_RdA	player_Philip-Salyer	player_RdA
player_Philip-Salyer_A.90min	player_Philip-Salyer	player_A.90min
player_Tim-Regan_Club	player_Tim-Regan	player_Club
player_Tim-Regan_POS	player_Tim-Regan	player_POS
player_Tim-Regan_GP	player_Tim-Regan	player_GP
player_Tim-Regan_GS	player_Tim-Regan	player_GS
player_Tim-Regan_A	player_Tim-Regan	player_A
player_Tim-Regan_GWA	player_Tim-Regan	player_GWA
player_Tim-Regan_HmA	player_Tim-Regan	player_HmA
player_Tim-Regan_RdA	player_Tim-Regan	player_RdA
player_Tim-Regan_A.90min	player_Tim-Regan	player_A.90min
player_Juan-Forchetti_Club	player_Juan-Forchetti	player_Club
player_Juan-Forchetti_POS	player_Juan-Forchetti	player_POS
player_Juan-Forchetti_GP	player_Juan-Forchetti	player_GP
player_Juan-Forchetti_GS	player_Juan-Forchetti	player_GS
player_Juan-Forchetti_A	player_Juan-Forchetti	player_A
player_Juan-Forchetti_GWA	player_Juan-Forchetti	player_GWA
player_Juan-Forchetti_HmA	player_Juan-Forchetti	player_HmA
player_Juan-Forchetti_RdA	player_Juan-Forchetti	player_RdA
player_Juan-Forchetti_A.90min	player_Juan-Forchetti	player_A.90min
player_Edgar-Bartolomeu_Club	player_Edgar-Bartolomeu	player_Club
player_Edgar-Bartolomeu_POS	player_Edgar-Bartolomeu	player_POS
player_Edgar-Bartolomeu_GP	player_Edgar-Bartolomeu	player_GP
player_Edgar-Bartolomeu_GS	player_Edgar-Bartolomeu	player_GS
player_Edgar-Bartolomeu_A	player_Edgar-Bartolomeu	player_A
player_Edgar-Bartolomeu_GWA	player_Edgar-Bartolomeu	player_GWA
player_Edgar-Bartolomeu_HmA	player_Edgar-Bartolomeu	player_HmA
player_Edgar-Bartolomeu_RdA	player_Edgar-Bartolomeu	player_RdA
player_Edgar-Bartolomeu_A.90min	player_Edgar-Bartolomeu	player_A.90min
player_Alex-Zotinca_Club	player_Alex-Zotinca	player_Club
player_Alex-Zotinca_POS	player_Alex-Zotinca	player_POS
player_Alex-Zotinca_GP	player_Alex-Zotinca	player_GP
player_Alex-Zotinca_GS	player_Alex-Zotinca	player_GS
player_Alex-Zotinca_A	player_Alex-Zotinca	player_A
player_Alex-Zotinca_GWA	player_Alex-Zotinca	player_GWA
player_Alex-Zotinca_HmA	player_Alex-Zotinca	player_HmA
player_Alex-Zotinca_RdA	player_Alex-Zotinca	player_RdA
player_Alex-Zotinca_A.90min	player_Alex-Zotinca	player_A.90min
player_Shavar-Thomas_Club	player_Shavar-Thomas	player_Club
player_Shavar-Thomas_POS	player_Shavar-Thomas	player_POS
player_Shavar-Thomas_GP	player_Shavar-Thomas	player_GP
player_Shavar-Thomas_GS	player_Shavar-Thomas	player_GS
player_Shavar-Thomas_A	player_Shavar-Thomas	player_A
player_Shavar-Thomas_GWA	player_Shavar-Thomas	player_GWA
player_Shavar-Thomas_HmA	player_Shavar-Thomas	player_HmA
player_Shavar-Thomas_RdA	player_Shavar-Thomas	player_RdA
player_Shavar-Thomas_A.90min	player_Shavar-Thomas	player_A.90min
player_Ryan-Suarez_Club	player_Ryan-Suarez	player_Club
player_Ryan-Suarez_POS	player_Ryan-Suarez	player_POS
player_Ryan-Suarez_GP	player_Ryan-Suarez	player_GP
player_Ryan-Suarez_GS	player_Ryan-Suarez	player_GS
player_Ryan-Suarez_A	player_Ryan-Suarez	player_A
player_Ryan-Suarez_GWA	player_Ryan-Suarez	player_GWA
player_Ryan-Suarez_HmA	player_Ryan-Suarez	player_HmA
player_Ryan-Suarez_RdA	player_Ryan-Suarez	player_RdA
player_Ryan-Suarez_A.90min	player_Ryan-Suarez	player_A.90min
player_Ryan-Nelsen_Club	player_Ryan-Nelsen	player_Club
player_Ryan-Nelsen_POS	player_Ryan-Nelsen	player_POS
player_Ryan-Nelsen_GP	player_Ryan-Nelsen	player_GP
player_Ryan-Nelsen_GS	player_Ryan-Nelsen	player_GS
player_Ryan-Nelsen_A	player_Ryan-Nelsen	player_A
player_Ryan-Nelsen_GWA	player_Ryan-Nelsen	player_GWA
player_Ryan-Nelsen_HmA	player_Ryan-Nelsen	player_HmA
player_Ryan-Nelsen_RdA	player_Ryan-Nelsen	player_RdA
player_Ryan-Nelsen_A.90min	player_Ryan-Nelsen	player_A.90min
player_Tony-Sanneh_Club	player_Tony-Sanneh	player_Club
player_Tony-Sanneh_POS	player_Tony-Sanneh	player_POS
player_Tony-Sanneh_GP	player_Tony-Sanneh	player_GP
player_Tony-Sanneh_GS	player_Tony-Sanneh	player_GS
player_Tony-Sanneh_A	player_Tony-Sanneh	player_A
player_Tony-Sanneh_GWA	player_Tony-Sanneh	player_GWA
player_Tony-Sanneh_HmA	player_Tony-Sanneh	player_HmA
player_Tony-Sanneh_RdA	player_Tony-Sanneh	player_RdA
player_Tony-Sanneh_A.90min	player_Tony-Sanneh	player_A.90min
player_Chris-Gbandi_Club	player_Chris-Gbandi	player_Club
player_Chris-Gbandi_POS	player_Chris-Gbandi	player_POS
player_Chris-Gbandi_GP	player_Chris-Gbandi	player_GP
player_Chris-Gbandi_GS	player_Chris-Gbandi	player_GS
player_Chris-Gbandi_A	player_Chris-Gbandi	player_A
player_Chris-Gbandi_GWA	player_Chris-Gbandi	player_GWA
player_Chris-Gbandi_HmA	player_Chris-Gbandi	player_HmA
player_Chris-Gbandi_RdA	player_Chris-Gbandi	player_RdA
player_Chris-Gbandi_A.90min	player_Chris-Gbandi	player_A.90min
player_Cory-Gibbs_Club	player_Cory-Gibbs	player_Club
player_Cory-Gibbs_POS	player_Cory-Gibbs	player_POS
player_Cory-Gibbs_GP	player_Cory-Gibbs	player_GP
player_Cory-Gibbs_GS	player_Cory-Gibbs	player_GS
player_Cory-Gibbs_A	player_Cory-Gibbs	player_A
player_Cory-Gibbs_GWA	player_Cory-Gibbs	player_GWA
player_Cory-Gibbs_HmA	player_Cory-Gibbs	player_HmA
player_Cory-Gibbs_RdA	player_Cory-Gibbs	player_RdA
player_Cory-Gibbs_A.90min	player_Cory-Gibbs	player_A.90min
player_Jeff-Parke_Club	player_Jeff-Parke	player_Club
player_Jeff-Parke_POS	player_Jeff-Parke	player_POS
player_Jeff-Parke_GP	player_Jeff-Parke	player_GP
player_Jeff-Parke_GS	player_Jeff-Parke	player_GS
player_Jeff-Parke_A	player_Jeff-Parke	player_A
player_Jeff-Parke_GWA	player_Jeff-Parke	player_GWA
player_Jeff-Parke_HmA	player_Jeff-Parke	player_HmA
player_Jeff-Parke_RdA	player_Jeff-Parke	player_RdA
player_Jeff-Parke_A.90min	player_Jeff-Parke	player_A.90min
player_David-Wagenfuhr_Club	player_David-Wagenfuhr	player_Club
player_David-Wagenfuhr_POS	player_David-Wagenfuhr	player_POS
player_David-Wagenfuhr_GP	player_David-Wagenfuhr	player_GP
player_David-Wagenfuhr_GS	player_David-Wagenfuhr	player_GS
player_David-Wagenfuhr_A	player_David-Wagenfuhr	player_A
player_David-Wagenfuhr_GWA	player_David-Wagenfuhr	player_GWA
player_David-Wagenfuhr_HmA	player_David-Wagenfuhr	player_HmA
player_David-Wagenfuhr_RdA	player_David-Wagenfuhr	player_RdA
player_David-Wagenfuhr_A.90min	player_David-Wagenfuhr	player_A.90min
player_Brian-Roberts_Club	player_Brian-Roberts	player_Club
player_Brian-Roberts_POS	player_Brian-Roberts	player_POS
player_Brian-Roberts_GP	player_Brian-Roberts	player_GP
player_Brian-Roberts_GS	player_Brian-Roberts	player_GS
player_Brian-Roberts_A	player_Brian-Roberts	player_A
player_Brian-Roberts_GWA	player_Brian-Roberts	player_GWA
player_Brian-Roberts_HmA	player_Brian-Roberts	player_HmA
player_Brian-Roberts_RdA	player_Brian-Roberts	player_RdA
player_Brian-Roberts_A.90min	player_Brian-Roberts	player_A.90min
player_Seth-Stammler_Club	player_Seth-Stammler	player_Club
player_Seth-Stammler_POS	player_Seth-Stammler	player_POS
player_Seth-Stammler_GP	player_Seth-Stammler	player_GP
player_Seth-Stammler_GS	player_Seth-Stammler	player_GS
player_Seth-Stammler_A	player_Seth-Stammler	player_A
player_Seth-Stammler_GWA	player_Seth-Stammler	player_GWA
player_Seth-Stammler_HmA	player_Seth-Stammler	player_HmA
player_Seth-Stammler_RdA	player_Seth-Stammler	player_RdA
player_Seth-Stammler_A.90min	player_Seth-Stammler	player_A.90min
player_Jake-Traeger_Club	player_Jake-Traeger	player_Club
player_Jake-Traeger_POS	player_Jake-Traeger	player_POS
player_Jake-Traeger_GP	player_Jake-Traeger	player_GP
player_Jake-Traeger_GS	player_Jake-Traeger	player_GS
player_Jake-Traeger_A	player_Jake-Traeger	player_A
player_Jake-Traeger_GWA	player_Jake-Traeger	player_GWA
player_Jake-Traeger_HmA	player_Jake-Traeger	player_HmA
player_Jake-Traeger_RdA	player_Jake-Traeger	player_RdA
player_Jake-Traeger_A.90min	player_Jake-Traeger	player_A.90min
player_G.R.-Cannon_Club	player_G.R.-Cannon	player_Club
player_G.R.-Cannon_POS	player_G.R.-Cannon	player_POS
player_G.R.-Cannon_GP	player_G.R.-Cannon	player_GP
player_G.R.-Cannon_GS	player_G.R.-Cannon	player_GS
player_G.R.-Cannon_A	player_G.R.-Cannon	player_A
player_G.R.-Cannon_GWA	player_G.R.-Cannon	player_GWA
player_G.R.-Cannon_HmA	player_G.R.-Cannon	player_HmA
player_G.R.-Cannon_RdA	player_G.R.-Cannon	player_RdA
player_G.R.-Cannon_A.90min	player_G.R.-Cannon	player_A.90min
player_Vuk-Rasovic_Club	player_Vuk-Rasovic	player_Club
player_Vuk-Rasovic_POS	player_Vuk-Rasovic	player_POS
player_Vuk-Rasovic_GP	player_Vuk-Rasovic	player_GP
player_Vuk-Rasovic_GS	player_Vuk-Rasovic	player_GS
player_Vuk-Rasovic_A	player_Vuk-Rasovic	player_A
player_Vuk-Rasovic_GWA	player_Vuk-Rasovic	player_GWA
player_Vuk-Rasovic_HmA	player_Vuk-Rasovic	player_HmA
player_Vuk-Rasovic_RdA	player_Vuk-Rasovic	player_RdA
player_Vuk-Rasovic_A.90min	player_Vuk-Rasovic	player_A.90min
player_Steve-Howey_Club	player_Steve-Howey	player_Club
player_Steve-Howey_POS	player_Steve-Howey	player_POS
player_Steve-Howey_GP	player_Steve-Howey	player_GP
player_Steve-Howey_GS	player_Steve-Howey	player_GS
player_Steve-Howey_A	player_Steve-Howey	player_A
player_Steve-Howey_GWA	player_Steve-Howey	player_GWA
player_Steve-Howey_HmA	player_Steve-Howey	player_HmA
player_Steve-Howey_RdA	player_Steve-Howey	player_RdA
player_Steve-Howey_A.90min	player_Steve-Howey	player_A.90min
player_Clarence-Goodson_Club	player_Clarence-Goodson	player_Club
player_Clarence-Goodson_POS	player_Clarence-Goodson	player_POS
player_Clarence-Goodson_GP	player_Clarence-Goodson	player_GP
player_Clarence-Goodson_GS	player_Clarence-Goodson	player_GS
player_Clarence-Goodson_A	player_Clarence-Goodson	player_A
player_Clarence-Goodson_GWA	player_Clarence-Goodson	player_GWA
player_Clarence-Goodson_HmA	player_Clarence-Goodson	player_HmA
player_Clarence-Goodson_RdA	player_Clarence-Goodson	player_RdA
player_Clarence-Goodson_A.90min	player_Clarence-Goodson	player_A.90min
player_Leonard-Griffin_Club	player_Leonard-Griffin	player_Club
player_Leonard-Griffin_POS	player_Leonard-Griffin	player_POS
player_Leonard-Griffin_GP	player_Leonard-Griffin	player_GP
player_Leonard-Griffin_GS	player_Leonard-Griffin	player_GS
player_Leonard-Griffin_A	player_Leonard-Griffin	player_A
player_Leonard-Griffin_GWA	player_Leonard-Griffin	player_GWA
player_Leonard-Griffin_HmA	player_Leonard-Griffin	player_HmA
player_Leonard-Griffin_RdA	player_Leonard-Griffin	player_RdA
player_Leonard-Griffin_A.90min	player_Leonard-Griffin	player_A.90min
player_Denny-Clanton_Club	player_Denny-Clanton	player_Club
player_Denny-Clanton_POS	player_Denny-Clanton	player_POS
player_Denny-Clanton_GP	player_Denny-Clanton	player_GP
player_Denny-Clanton_GS	player_Denny-Clanton	player_GS
player_Denny-Clanton_A	player_Denny-Clanton	player_A
player_Denny-Clanton_GWA	player_Denny-Clanton	player_GWA
player_Denny-Clanton_HmA	player_Denny-Clanton	player_HmA
player_Denny-Clanton_RdA	player_Denny-Clanton	player_RdA
player_Denny-Clanton_A.90min	player_Denny-Clanton	player_A.90min
player_Stephen-Herdsman_Club	player_Stephen-Herdsman	player_Club
player_Stephen-Herdsman_POS	player_Stephen-Herdsman	player_POS
player_Stephen-Herdsman_GP	player_Stephen-Herdsman	player_GP
player_Stephen-Herdsman_GS	player_Stephen-Herdsman	player_GS
player_Stephen-Herdsman_A	player_Stephen-Herdsman	player_A
player_Stephen-Herdsman_GWA	player_Stephen-Herdsman	player_GWA
player_Stephen-Herdsman_HmA	player_Stephen-Herdsman	player_HmA
player_Stephen-Herdsman_RdA	player_Stephen-Herdsman	player_RdA
player_Stephen-Herdsman_A.90min	player_Stephen-Herdsman	player_A.90min
player_Pablo-Brenes_Club	player_Pablo-Brenes	player_Club
player_Pablo-Brenes_POS	player_Pablo-Brenes	player_POS
player_Pablo-Brenes_GP	player_Pablo-Brenes	player_GP
player_Pablo-Brenes_GS	player_Pablo-Brenes	player_GS
player_Pablo-Brenes_A	player_Pablo-Brenes	player_A
player_Pablo-Brenes_GWA	player_Pablo-Brenes	player_GWA
player_Pablo-Brenes_HmA	player_Pablo-Brenes	player_HmA
player_Pablo-Brenes_RdA	player_Pablo-Brenes	player_RdA
player_Pablo-Brenes_A.90min	player_Pablo-Brenes	player_A.90min
player_Milton-Reyes_Club	player_Milton-Reyes	player_Club
player_Milton-Reyes_POS	player_Milton-Reyes	player_POS
player_Milton-Reyes_GP	player_Milton-Reyes	player_GP
player_Milton-Reyes_GS	player_Milton-Reyes	player_GS
player_Milton-Reyes_A	player_Milton-Reyes	player_A
player_Milton-Reyes_GWA	player_Milton-Reyes	player_GWA
player_Milton-Reyes_HmA	player_Milton-Reyes	player_HmA
player_Milton-Reyes_RdA	player_Milton-Reyes	player_RdA
player_Milton-Reyes_A.90min	player_Milton-Reyes	player_A.90min
player_Avery-John_Club	player_Avery-John	player_Club
player_Avery-John_POS	player_Avery-John	player_POS
player_Avery-John_GP	player_Avery-John	player_GP
player_Avery-John_GS	player_Avery-John	player_GS
player_Avery-John_A	player_Avery-John	player_A
player_Avery-John_GWA	player_Avery-John	player_GWA
player_Avery-John_HmA	player_Avery-John	player_HmA
player_Avery-John_RdA	player_Avery-John	player_RdA
player_Avery-John_A.90min	player_Avery-John	player_A.90min
player_Robin-Fraser_Club	player_Robin-Fraser	player_Club
player_Robin-Fraser_POS	player_Robin-Fraser	player_POS
player_Robin-Fraser_GP	player_Robin-Fraser	player_GP
player_Robin-Fraser_GS	player_Robin-Fraser	player_GS
player_Robin-Fraser_A	player_Robin-Fraser	player_A
player_Robin-Fraser_GWA	player_Robin-Fraser	player_GWA
player_Robin-Fraser_HmA	player_Robin-Fraser	player_HmA
player_Robin-Fraser_RdA	player_Robin-Fraser	player_RdA
player_Robin-Fraser_A.90min	player_Robin-Fraser	player_A.90min
player_Samuel-Caballero_Club	player_Samuel-Caballero	player_Club
player_Samuel-Caballero_POS	player_Samuel-Caballero	player_POS
player_Samuel-Caballero_GP	player_Samuel-Caballero	player_GP
player_Samuel-Caballero_GS	player_Samuel-Caballero	player_GS
player_Samuel-Caballero_A	player_Samuel-Caballero	player_A
player_Samuel-Caballero_GWA	player_Samuel-Caballero	player_GWA
player_Samuel-Caballero_HmA	player_Samuel-Caballero	player_HmA
player_Samuel-Caballero_RdA	player_Samuel-Caballero	player_RdA
player_Samuel-Caballero_A.90min	player_Samuel-Caballero	player_A.90min
player_Aaron-Pitchkolan_Club	player_Aaron-Pitchkolan	player_Club
player_Aaron-Pitchkolan_POS	player_Aaron-Pitchkolan	player_POS
player_Aaron-Pitchkolan_GP	player_Aaron-Pitchkolan	player_GP
player_Aaron-Pitchkolan_GS	player_Aaron-Pitchkolan	player_GS
player_Aaron-Pitchkolan_A	player_Aaron-Pitchkolan	player_A
player_Aaron-Pitchkolan_GWA	player_Aaron-Pitchkolan	player_GWA
player_Aaron-Pitchkolan_HmA	player_Aaron-Pitchkolan	player_HmA
player_Aaron-Pitchkolan_RdA	player_Aaron-Pitchkolan	player_RdA
player_Aaron-Pitchkolan_A.90min	player_Aaron-Pitchkolan	player_A.90min
player_Mark-Schulte_Club	player_Mark-Schulte	player_Club
player_Mark-Schulte_POS	player_Mark-Schulte	player_POS
player_Mark-Schulte_GP	player_Mark-Schulte	player_GP
player_Mark-Schulte_GS	player_Mark-Schulte	player_GS
player_Mark-Schulte_A	player_Mark-Schulte	player_A
player_Mark-Schulte_GWA	player_Mark-Schulte	player_GWA
player_Mark-Schulte_HmA	player_Mark-Schulte	player_HmA
player_Mark-Schulte_RdA	player_Mark-Schulte	player_RdA
player_Mark-Schulte_A.90min	player_Mark-Schulte	player_A.90min
player_Greg-Vanney_Club	player_Greg-Vanney	player_Club
player_Greg-Vanney_POS	player_Greg-Vanney	player_POS
player_Greg-Vanney_GP	player_Greg-Vanney	player_GP
player_Greg-Vanney_GS	player_Greg-Vanney	player_GS
player_Greg-Vanney_A	player_Greg-Vanney	player_A
player_Greg-Vanney_GWA	player_Greg-Vanney	player_GWA
player_Greg-Vanney_HmA	player_Greg-Vanney	player_HmA
player_Greg-Vanney_RdA	player_Greg-Vanney	player_RdA
player_Greg-Vanney_A.90min	player_Greg-Vanney	player_A.90min
player_Bobby-Boswell_Club	player_Bobby-Boswell	player_Club
player_Bobby-Boswell_POS	player_Bobby-Boswell	player_POS
player_Bobby-Boswell_GP	player_Bobby-Boswell	player_GP
player_Bobby-Boswell_GS	player_Bobby-Boswell	player_GS
player_Bobby-Boswell_A	player_Bobby-Boswell	player_A
player_Bobby-Boswell_GWA	player_Bobby-Boswell	player_GWA
player_Bobby-Boswell_HmA	player_Bobby-Boswell	player_HmA
player_Bobby-Boswell_RdA	player_Bobby-Boswell	player_RdA
player_Bobby-Boswell_A.90min	player_Bobby-Boswell	player_A.90min
player_Tony-Lochhead_Club	player_Tony-Lochhead	player_Club
player_Tony-Lochhead_POS	player_Tony-Lochhead	player_POS
player_Tony-Lochhead_GP	player_Tony-Lochhead	player_GP
player_Tony-Lochhead_GS	player_Tony-Lochhead	player_GS
player_Tony-Lochhead_A	player_Tony-Lochhead	player_A
player_Tony-Lochhead_GWA	player_Tony-Lochhead	player_GWA
player_Tony-Lochhead_HmA	player_Tony-Lochhead	player_HmA
player_Tony-Lochhead_RdA	player_Tony-Lochhead	player_RdA
player_Tony-Lochhead_A.90min	player_Tony-Lochhead	player_A.90min
player_Mamadou-Diallo_Club	player_Mamadou-Diallo	player_Club
player_Mamadou-Diallo_POS	player_Mamadou-Diallo	player_POS
player_Mamadou-Diallo_GP	player_Mamadou-Diallo	player_GP
player_Mamadou-Diallo_GS	player_Mamadou-Diallo	player_GS
player_Mamadou-Diallo_A	player_Mamadou-Diallo	player_A
player_Mamadou-Diallo_GWA	player_Mamadou-Diallo	player_GWA
player_Mamadou-Diallo_HmA	player_Mamadou-Diallo	player_HmA
player_Mamadou-Diallo_RdA	player_Mamadou-Diallo	player_RdA
player_Mamadou-Diallo_A.90min	player_Mamadou-Diallo	player_A.90min
player_Daniel-Dobson_Club	player_Daniel-Dobson	player_Club
player_Daniel-Dobson_POS	player_Daniel-Dobson	player_POS
player_Daniel-Dobson_GP	player_Daniel-Dobson	player_GP
player_Daniel-Dobson_GS	player_Daniel-Dobson	player_GS
player_Daniel-Dobson_A	player_Daniel-Dobson	player_A
player_Daniel-Dobson_GWA	player_Daniel-Dobson	player_GWA
player_Daniel-Dobson_HmA	player_Daniel-Dobson	player_HmA
player_Daniel-Dobson_RdA	player_Daniel-Dobson	player_RdA
player_Daniel-Dobson_A.90min	player_Daniel-Dobson	player_A.90min
player_Hollis-Donaldson_Club	player_Hollis-Donaldson	player_Club
player_Hollis-Donaldson_POS	player_Hollis-Donaldson	player_POS
player_Hollis-Donaldson_GP	player_Hollis-Donaldson	player_GP
player_Hollis-Donaldson_GS	player_Hollis-Donaldson	player_GS
player_Hollis-Donaldson_A	player_Hollis-Donaldson	player_A
player_Hollis-Donaldson_GWA	player_Hollis-Donaldson	player_GWA
player_Hollis-Donaldson_HmA	player_Hollis-Donaldson	player_HmA
player_Hollis-Donaldson_RdA	player_Hollis-Donaldson	player_RdA
player_Hollis-Donaldson_A.90min	player_Hollis-Donaldson	player_A.90min
player_Stephen-deRoux_Club	player_Stephen-deRoux	player_Club
player_Stephen-deRoux_POS	player_Stephen-deRoux	player_POS
player_Stephen-deRoux_GP	player_Stephen-deRoux	player_GP
player_Stephen-deRoux_GS	player_Stephen-deRoux	player_GS
player_Stephen-deRoux_A	player_Stephen-deRoux	player_A
player_Stephen-deRoux_GWA	player_Stephen-deRoux	player_GWA
player_Stephen-deRoux_HmA	player_Stephen-deRoux	player_HmA
player_Stephen-deRoux_RdA	player_Stephen-deRoux	player_RdA
player_Stephen-deRoux_A.90min	player_Stephen-deRoux	player_A.90min
player_Tim-Merritt_Club	player_Tim-Merritt	player_Club
player_Tim-Merritt_POS	player_Tim-Merritt	player_POS
player_Tim-Merritt_GP	player_Tim-Merritt	player_GP
player_Tim-Merritt_GS	player_Tim-Merritt	player_GS
player_Tim-Merritt_A	player_Tim-Merritt	player_A
player_Tim-Merritt_GWA	player_Tim-Merritt	player_GWA
player_Tim-Merritt_HmA	player_Tim-Merritt	player_HmA
player_Tim-Merritt_RdA	player_Tim-Merritt	player_RdA
player_Tim-Merritt_A.90min	player_Tim-Merritt	player_A.90min
player_Jared-Montz_Club	player_Jared-Montz	player_Club
player_Jared-Montz_POS	player_Jared-Montz	player_POS
player_Jared-Montz_GP	player_Jared-Montz	player_GP
player_Jared-Montz_GS	player_Jared-Montz	player_GS
player_Jared-Montz_A	player_Jared-Montz	player_A
player_Jared-Montz_GWA	player_Jared-Montz	player_GWA
player_Jared-Montz_HmA	player_Jared-Montz	player_HmA
player_Jared-Montz_RdA	player_Jared-Montz	player_RdA
player_Jared-Montz_A.90min	player_Jared-Montz	player_A.90min
player_Winston-Marshall_Club	player_Winston-Marshall	player_Club
player_Winston-Marshall_POS	player_Winston-Marshall	player_POS
player_Winston-Marshall_GP	player_Winston-Marshall	player_GP
player_Winston-Marshall_GS	player_Winston-Marshall	player_GS
player_Winston-Marshall_A	player_Winston-Marshall	player_A
player_Winston-Marshall_GWA	player_Winston-Marshall	player_GWA
player_Winston-Marshall_HmA	player_Winston-Marshall	player_HmA
player_Winston-Marshall_RdA	player_Winston-Marshall	player_RdA
player_Winston-Marshall_A.90min	player_Winston-Marshall	player_A.90min
player_Dustin-Branan_Club	player_Dustin-Branan	player_Club
player_Dustin-Branan_POS	player_Dustin-Branan	player_POS
player_Dustin-Branan_GP	player_Dustin-Branan	player_GP
player_Dustin-Branan_GS	player_Dustin-Branan	player_GS
player_Dustin-Branan_A	player_Dustin-Branan	player_A
player_Dustin-Branan_GWA	player_Dustin-Branan	player_GWA
player_Dustin-Branan_HmA	player_Dustin-Branan	player_HmA
player_Dustin-Branan_RdA	player_Dustin-Branan	player_RdA
player_Dustin-Branan_A.90min	player_Dustin-Branan	player_A.90min
player_Ryan-Raybould_Club	player_Ryan-Raybould	player_Club
player_Ryan-Raybould_POS	player_Ryan-Raybould	player_POS
player_Ryan-Raybould_GP	player_Ryan-Raybould	player_GP
player_Ryan-Raybould_GS	player_Ryan-Raybould	player_GS
player_Ryan-Raybould_A	player_Ryan-Raybould	player_A
player_Ryan-Raybould_GWA	player_Ryan-Raybould	player_GWA
player_Ryan-Raybould_HmA	player_Ryan-Raybould	player_HmA
player_Ryan-Raybould_RdA	player_Ryan-Raybould	player_RdA
player_Ryan-Raybould_A.90min	player_Ryan-Raybould	player_A.90min
player_Alex-Yi_Club	player_Alex-Yi	player_Club
player_Alex-Yi_POS	player_Alex-Yi	player_POS
player_Alex-Yi_GP	player_Alex-Yi	player_GP
player_Alex-Yi_GS	player_Alex-Yi	player_GS
player_Alex-Yi_A	player_Alex-Yi	player_A
player_Alex-Yi_GWA	player_Alex-Yi	player_GWA
player_Alex-Yi_HmA	player_Alex-Yi	player_HmA
player_Alex-Yi_RdA	player_Alex-Yi	player_RdA
player_Alex-Yi_A.90min	player_Alex-Yi	player_A.90min
player_Will-Johnson_Club	player_Will-Johnson	player_Club
player_Will-Johnson_POS	player_Will-Johnson	player_POS
player_Will-Johnson_GP	player_Will-Johnson	player_GP
player_Will-Johnson_GS	player_Will-Johnson	player_GS
player_Will-Johnson_A	player_Will-Johnson	player_A
player_Will-Johnson_GWA	player_Will-Johnson	player_GWA
player_Will-Johnson_HmA	player_Will-Johnson	player_HmA
player_Will-Johnson_RdA	player_Will-Johnson	player_RdA
player_Will-Johnson_A.90min	player_Will-Johnson	player_A.90min
player_Jason-Hernandez_Club	player_Jason-Hernandez	player_Club
player_Jason-Hernandez_POS	player_Jason-Hernandez	player_POS
player_Jason-Hernandez_GP	player_Jason-Hernandez	player_GP
player_Jason-Hernandez_GS	player_Jason-Hernandez	player_GS
player_Jason-Hernandez_A	player_Jason-Hernandez	player_A
player_Jason-Hernandez_GWA	player_Jason-Hernandez	player_GWA
player_Jason-Hernandez_HmA	player_Jason-Hernandez	player_HmA
player_Jason-Hernandez_RdA	player_Jason-Hernandez	player_RdA
player_Jason-Hernandez_A.90min	player_Jason-Hernandez	player_A.90min
player_Ryan-Kelly_Club	player_Ryan-Kelly	player_Club
player_Ryan-Kelly_POS	player_Ryan-Kelly	player_POS
player_Ryan-Kelly_GP	player_Ryan-Kelly	player_GP
player_Ryan-Kelly_GS	player_Ryan-Kelly	player_GS
player_Ryan-Kelly_A	player_Ryan-Kelly	player_A
player_Ryan-Kelly_GWA	player_Ryan-Kelly	player_GWA
player_Ryan-Kelly_HmA	player_Ryan-Kelly	player_HmA
player_Ryan-Kelly_RdA	player_Ryan-Kelly	player_RdA
player_Ryan-Kelly_A.90min	player_Ryan-Kelly	player_A.90min
player_Jack-Stewart_Club	player_Jack-Stewart	player_Club
player_Jack-Stewart_POS	player_Jack-Stewart	player_POS
player_Jack-Stewart_GP	player_Jack-Stewart	player_GP
player_Jack-Stewart_GS	player_Jack-Stewart	player_GS
player_Jack-Stewart_A	player_Jack-Stewart	player_A
player_Jack-Stewart_GWA	player_Jack-Stewart	player_GWA
player_Jack-Stewart_HmA	player_Jack-Stewart	player_HmA
player_Jack-Stewart_RdA	player_Jack-Stewart	player_RdA
player_Jack-Stewart_A.90min	player_Jack-Stewart	player_A.90min
player_Facundo-Erpen_Club	player_Facundo-Erpen	player_Club
player_Facundo-Erpen_POS	player_Facundo-Erpen	player_POS
player_Facundo-Erpen_GP	player_Facundo-Erpen	player_GP
player_Facundo-Erpen_GS	player_Facundo-Erpen	player_GS
player_Facundo-Erpen_A	player_Facundo-Erpen	player_A
player_Facundo-Erpen_GWA	player_Facundo-Erpen	player_GWA
player_Facundo-Erpen_HmA	player_Facundo-Erpen	player_HmA
player_Facundo-Erpen_RdA	player_Facundo-Erpen	player_RdA
player_Facundo-Erpen_A.90min	player_Facundo-Erpen	player_A.90min
player_Drew-Moor_Club	player_Drew-Moor	player_Club
player_Drew-Moor_POS	player_Drew-Moor	player_POS
player_Drew-Moor_GP	player_Drew-Moor	player_GP
player_Drew-Moor_GS	player_Drew-Moor	player_GS
player_Drew-Moor_A	player_Drew-Moor	player_A
player_Drew-Moor_GWA	player_Drew-Moor	player_GWA
player_Drew-Moor_HmA	player_Drew-Moor	player_HmA
player_Drew-Moor_RdA	player_Drew-Moor	player_RdA
player_Drew-Moor_A.90min	player_Drew-Moor	player_A.90min
player_Chris-Wingert_Club	player_Chris-Wingert	player_Club
player_Chris-Wingert_POS	player_Chris-Wingert	player_POS
player_Chris-Wingert_GP	player_Chris-Wingert	player_GP
player_Chris-Wingert_GS	player_Chris-Wingert	player_GS
player_Chris-Wingert_A	player_Chris-Wingert	player_A
player_Chris-Wingert_GWA	player_Chris-Wingert	player_GWA
player_Chris-Wingert_HmA	player_Chris-Wingert	player_HmA
player_Chris-Wingert_RdA	player_Chris-Wingert	player_RdA
player_Chris-Wingert_A.90min	player_Chris-Wingert	player_A.90min
player_Carlos-Mendes_Club	player_Carlos-Mendes	player_Club
player_Carlos-Mendes_POS	player_Carlos-Mendes	player_POS
player_Carlos-Mendes_GP	player_Carlos-Mendes	player_GP
player_Carlos-Mendes_GS	player_Carlos-Mendes	player_GS
player_Carlos-Mendes_A	player_Carlos-Mendes	player_A
player_Carlos-Mendes_GWA	player_Carlos-Mendes	player_GWA
player_Carlos-Mendes_HmA	player_Carlos-Mendes	player_HmA
player_Carlos-Mendes_RdA	player_Carlos-Mendes	player_RdA
player_Carlos-Mendes_A.90min	player_Carlos-Mendes	player_A.90min
player_Jeff-Agoos_Club	player_Jeff-Agoos	player_Club
player_Jeff-Agoos_POS	player_Jeff-Agoos	player_POS
player_Jeff-Agoos_GP	player_Jeff-Agoos	player_GP
player_Jeff-Agoos_GS	player_Jeff-Agoos	player_GS
player_Jeff-Agoos_A	player_Jeff-Agoos	player_A
player_Jeff-Agoos_GWA	player_Jeff-Agoos	player_GWA
player_Jeff-Agoos_HmA	player_Jeff-Agoos	player_HmA
player_Jeff-Agoos_RdA	player_Jeff-Agoos	player_RdA
player_Jeff-Agoos_A.90min	player_Jeff-Agoos	player_A.90min
player_Michael-Parkhurst_Club	player_Michael-Parkhurst	player_Club
player_Michael-Parkhurst_POS	player_Michael-Parkhurst	player_POS
player_Michael-Parkhurst_GP	player_Michael-Parkhurst	player_GP
player_Michael-Parkhurst_GS	player_Michael-Parkhurst	player_GS
player_Michael-Parkhurst_A	player_Michael-Parkhurst	player_A
player_Michael-Parkhurst_GWA	player_Michael-Parkhurst	player_GWA
player_Michael-Parkhurst_HmA	player_Michael-Parkhurst	player_HmA
player_Michael-Parkhurst_RdA	player_Michael-Parkhurst	player_RdA
player_Michael-Parkhurst_A.90min	player_Michael-Parkhurst	player_A.90min
player_Marc-Burch_Club	player_Marc-Burch	player_Club
player_Marc-Burch_POS	player_Marc-Burch	player_POS
player_Marc-Burch_GP	player_Marc-Burch	player_GP
player_Marc-Burch_GS	player_Marc-Burch	player_GS
player_Marc-Burch_A	player_Marc-Burch	player_A
player_Marc-Burch_GWA	player_Marc-Burch	player_GWA
player_Marc-Burch_HmA	player_Marc-Burch	player_HmA
player_Marc-Burch_RdA	player_Marc-Burch	player_RdA
player_Marc-Burch_A.90min	player_Marc-Burch	player_A.90min
player_Kevin-Goldthwaite_Club	player_Kevin-Goldthwaite	player_Club
player_Kevin-Goldthwaite_POS	player_Kevin-Goldthwaite	player_POS
player_Kevin-Goldthwaite_GP	player_Kevin-Goldthwaite	player_GP
player_Kevin-Goldthwaite_GS	player_Kevin-Goldthwaite	player_GS
player_Kevin-Goldthwaite_A	player_Kevin-Goldthwaite	player_A
player_Kevin-Goldthwaite_GWA	player_Kevin-Goldthwaite	player_GWA
player_Kevin-Goldthwaite_HmA	player_Kevin-Goldthwaite	player_HmA
player_Kevin-Goldthwaite_RdA	player_Kevin-Goldthwaite	player_RdA
player_Kevin-Goldthwaite_A.90min	player_Kevin-Goldthwaite	player_A.90min
player_Gonzalo-Segares_Club	player_Gonzalo-Segares	player_Club
player_Gonzalo-Segares_POS	player_Gonzalo-Segares	player_POS
player_Gonzalo-Segares_GP	player_Gonzalo-Segares	player_GP
player_Gonzalo-Segares_GS	player_Gonzalo-Segares	player_GS
player_Gonzalo-Segares_A	player_Gonzalo-Segares	player_A
player_Gonzalo-Segares_GWA	player_Gonzalo-Segares	player_GWA
player_Gonzalo-Segares_HmA	player_Gonzalo-Segares	player_HmA
player_Gonzalo-Segares_RdA	player_Gonzalo-Segares	player_RdA
player_Gonzalo-Segares_A.90min	player_Gonzalo-Segares	player_A.90min
player_Craig-Waibel_Club	player_Craig-Waibel	player_Club
player_Craig-Waibel_POS	player_Craig-Waibel	player_POS
player_Craig-Waibel_GP	player_Craig-Waibel	player_GP
player_Craig-Waibel_GS	player_Craig-Waibel	player_GS
player_Craig-Waibel_A	player_Craig-Waibel	player_A
player_Craig-Waibel_GWA	player_Craig-Waibel	player_GWA
player_Craig-Waibel_HmA	player_Craig-Waibel	player_HmA
player_Craig-Waibel_RdA	player_Craig-Waibel	player_RdA
player_Craig-Waibel_A.90min	player_Craig-Waibel	player_A.90min
player_Jed-Zayner_Club	player_Jed-Zayner	player_Club
player_Jed-Zayner_POS	player_Jed-Zayner	player_POS
player_Jed-Zayner_GP	player_Jed-Zayner	player_GP
player_Jed-Zayner_GS	player_Jed-Zayner	player_GS
player_Jed-Zayner_A	player_Jed-Zayner	player_A
player_Jed-Zayner_GWA	player_Jed-Zayner	player_GWA
player_Jed-Zayner_HmA	player_Jed-Zayner	player_HmA
player_Jed-Zayner_RdA	player_Jed-Zayner	player_RdA
player_Jed-Zayner_A.90min	player_Jed-Zayner	player_A.90min
player_Mike-Chabala_Club	player_Mike-Chabala	player_Club
player_Mike-Chabala_POS	player_Mike-Chabala	player_POS
player_Mike-Chabala_GP	player_Mike-Chabala	player_GP
player_Mike-Chabala_GS	player_Mike-Chabala	player_GS
player_Mike-Chabala_A	player_Mike-Chabala	player_A
player_Mike-Chabala_GWA	player_Mike-Chabala	player_GWA
player_Mike-Chabala_HmA	player_Mike-Chabala	player_HmA
player_Mike-Chabala_RdA	player_Mike-Chabala	player_RdA
player_Mike-Chabala_A.90min	player_Mike-Chabala	player_A.90min
player_Michael-Dello-Russo_Club	player_Michael-Dello-Russo	player_Club
player_Michael-Dello-Russo_POS	player_Michael-Dello-Russo	player_POS
player_Michael-Dello-Russo_GP	player_Michael-Dello-Russo	player_GP
player_Michael-Dello-Russo_GS	player_Michael-Dello-Russo	player_GS
player_Michael-Dello-Russo_A	player_Michael-Dello-Russo	player_A
player_Michael-Dello-Russo_GWA	player_Michael-Dello-Russo	player_GWA
player_Michael-Dello-Russo_HmA	player_Michael-Dello-Russo	player_HmA
player_Michael-Dello-Russo_RdA	player_Michael-Dello-Russo	player_RdA
player_Michael-Dello-Russo_A.90min	player_Michael-Dello-Russo	player_A.90min
player_Blake-Wagner_Club	player_Blake-Wagner	player_Club
player_Blake-Wagner_POS	player_Blake-Wagner	player_POS
player_Blake-Wagner_GP	player_Blake-Wagner	player_GP
player_Blake-Wagner_GS	player_Blake-Wagner	player_GS
player_Blake-Wagner_A	player_Blake-Wagner	player_A
player_Blake-Wagner_GWA	player_Blake-Wagner	player_GWA
player_Blake-Wagner_HmA	player_Blake-Wagner	player_HmA
player_Blake-Wagner_RdA	player_Blake-Wagner	player_RdA
player_Blake-Wagner_A.90min	player_Blake-Wagner	player_A.90min
player_Marcos-Charras_Club	player_Marcos-Charras	player_Club
player_Marcos-Charras_POS	player_Marcos-Charras	player_POS
player_Marcos-Charras_GP	player_Marcos-Charras	player_GP
player_Marcos-Charras_GS	player_Marcos-Charras	player_GS
player_Marcos-Charras_A	player_Marcos-Charras	player_A
player_Marcos-Charras_GWA	player_Marcos-Charras	player_GWA
player_Marcos-Charras_HmA	player_Marcos-Charras	player_HmA
player_Marcos-Charras_RdA	player_Marcos-Charras	player_RdA
player_Marcos-Charras_A.90min	player_Marcos-Charras	player_A.90min
player_Chris-Aloisi_Club	player_Chris-Aloisi	player_Club
player_Chris-Aloisi_POS	player_Chris-Aloisi	player_POS
player_Chris-Aloisi_GP	player_Chris-Aloisi	player_GP
player_Chris-Aloisi_GS	player_Chris-Aloisi	player_GS
player_Chris-Aloisi_A	player_Chris-Aloisi	player_A
player_Chris-Aloisi_GWA	player_Chris-Aloisi	player_GWA
player_Chris-Aloisi_HmA	player_Chris-Aloisi	player_HmA
player_Chris-Aloisi_RdA	player_Chris-Aloisi	player_RdA
player_Chris-Aloisi_A.90min	player_Chris-Aloisi	player_A.90min
player_Jordan-Russolillo_Club	player_Jordan-Russolillo	player_Club
player_Jordan-Russolillo_POS	player_Jordan-Russolillo	player_POS
player_Jordan-Russolillo_GP	player_Jordan-Russolillo	player_GP
player_Jordan-Russolillo_GS	player_Jordan-Russolillo	player_GS
player_Jordan-Russolillo_A	player_Jordan-Russolillo	player_A
player_Jordan-Russolillo_GWA	player_Jordan-Russolillo	player_GWA
player_Jordan-Russolillo_HmA	player_Jordan-Russolillo	player_HmA
player_Jordan-Russolillo_RdA	player_Jordan-Russolillo	player_RdA
player_Jordan-Russolillo_A.90min	player_Jordan-Russolillo	player_A.90min
player_Jeff-Curtin_Club	player_Jeff-Curtin	player_Club
player_Jeff-Curtin_POS	player_Jeff-Curtin	player_POS
player_Jeff-Curtin_GP	player_Jeff-Curtin	player_GP
player_Jeff-Curtin_GS	player_Jeff-Curtin	player_GS
player_Jeff-Curtin_A	player_Jeff-Curtin	player_A
player_Jeff-Curtin_GWA	player_Jeff-Curtin	player_GWA
player_Jeff-Curtin_HmA	player_Jeff-Curtin	player_HmA
player_Jeff-Curtin_RdA	player_Jeff-Curtin	player_RdA
player_Jeff-Curtin_A.90min	player_Jeff-Curtin	player_A.90min
player_Stephen-Shirley_Club	player_Stephen-Shirley	player_Club
player_Stephen-Shirley_POS	player_Stephen-Shirley	player_POS
player_Stephen-Shirley_GP	player_Stephen-Shirley	player_GP
player_Stephen-Shirley_GS	player_Stephen-Shirley	player_GS
player_Stephen-Shirley_A	player_Stephen-Shirley	player_A
player_Stephen-Shirley_GWA	player_Stephen-Shirley	player_GWA
player_Stephen-Shirley_HmA	player_Stephen-Shirley	player_HmA
player_Stephen-Shirley_RdA	player_Stephen-Shirley	player_RdA
player_Stephen-Shirley_A.90min	player_Stephen-Shirley	player_A.90min
player_Idris-Ughiovhe_Club	player_Idris-Ughiovhe	player_Club
player_Idris-Ughiovhe_POS	player_Idris-Ughiovhe	player_POS
player_Idris-Ughiovhe_GP	player_Idris-Ughiovhe	player_GP
player_Idris-Ughiovhe_GS	player_Idris-Ughiovhe	player_GS
player_Idris-Ughiovhe_A	player_Idris-Ughiovhe	player_A
player_Idris-Ughiovhe_GWA	player_Idris-Ughiovhe	player_GWA
player_Idris-Ughiovhe_HmA	player_Idris-Ughiovhe	player_HmA
player_Idris-Ughiovhe_RdA	player_Idris-Ughiovhe	player_RdA
player_Idris-Ughiovhe_A.90min	player_Idris-Ughiovhe	player_A.90min
player_Pat-Haggerty_Club	player_Pat-Haggerty	player_Club
player_Pat-Haggerty_POS	player_Pat-Haggerty	player_POS
player_Pat-Haggerty_GP	player_Pat-Haggerty	player_GP
player_Pat-Haggerty_GS	player_Pat-Haggerty	player_GS
player_Pat-Haggerty_A	player_Pat-Haggerty	player_A
player_Pat-Haggerty_GWA	player_Pat-Haggerty	player_GWA
player_Pat-Haggerty_HmA	player_Pat-Haggerty	player_HmA
player_Pat-Haggerty_RdA	player_Pat-Haggerty	player_RdA
player_Pat-Haggerty_A.90min	player_Pat-Haggerty	player_A.90min
player_Patrick-Ianni_Club	player_Patrick-Ianni	player_Club
player_Patrick-Ianni_POS	player_Patrick-Ianni	player_POS
player_Patrick-Ianni_GP	player_Patrick-Ianni	player_GP
player_Patrick-Ianni_GS	player_Patrick-Ianni	player_GS
player_Patrick-Ianni_A	player_Patrick-Ianni	player_A
player_Patrick-Ianni_GWA	player_Patrick-Ianni	player_GWA
player_Patrick-Ianni_HmA	player_Patrick-Ianni	player_HmA
player_Patrick-Ianni_RdA	player_Patrick-Ianni	player_RdA
player_Patrick-Ianni_A.90min	player_Patrick-Ianni	player_A.90min
player_Joel-Kitamirike_Club	player_Joel-Kitamirike	player_Club
player_Joel-Kitamirike_POS	player_Joel-Kitamirike	player_POS
player_Joel-Kitamirike_GP	player_Joel-Kitamirike	player_GP
player_Joel-Kitamirike_GS	player_Joel-Kitamirike	player_GS
player_Joel-Kitamirike_A	player_Joel-Kitamirike	player_A
player_Joel-Kitamirike_GWA	player_Joel-Kitamirike	player_GWA
player_Joel-Kitamirike_HmA	player_Joel-Kitamirike	player_HmA
player_Joel-Kitamirike_RdA	player_Joel-Kitamirike	player_RdA
player_Joel-Kitamirike_A.90min	player_Joel-Kitamirike	player_A.90min
player_Danny-Wynn_Club	player_Danny-Wynn	player_Club
player_Danny-Wynn_POS	player_Danny-Wynn	player_POS
player_Danny-Wynn_GP	player_Danny-Wynn	player_GP
player_Danny-Wynn_GS	player_Danny-Wynn	player_GS
player_Danny-Wynn_A	player_Danny-Wynn	player_A
player_Danny-Wynn_GWA	player_Danny-Wynn	player_GWA
player_Danny-Wynn_HmA	player_Danny-Wynn	player_HmA
player_Danny-Wynn_RdA	player_Danny-Wynn	player_RdA
player_Danny-Wynn_A.90min	player_Danny-Wynn	player_A.90min
player_Jeff-Carroll_Club	player_Jeff-Carroll	player_Club
player_Jeff-Carroll_POS	player_Jeff-Carroll	player_POS
player_Jeff-Carroll_GP	player_Jeff-Carroll	player_GP
player_Jeff-Carroll_GS	player_Jeff-Carroll	player_GS
player_Jeff-Carroll_A	player_Jeff-Carroll	player_A
player_Jeff-Carroll_GWA	player_Jeff-Carroll	player_GWA
player_Jeff-Carroll_HmA	player_Jeff-Carroll	player_HmA
player_Jeff-Carroll_RdA	player_Jeff-Carroll	player_RdA
player_Jeff-Carroll_A.90min	player_Jeff-Carroll	player_A.90min
player_Markus-Schopp_Club	player_Markus-Schopp	player_Club
player_Markus-Schopp_POS	player_Markus-Schopp	player_POS
player_Markus-Schopp_GP	player_Markus-Schopp	player_GP
player_Markus-Schopp_GS	player_Markus-Schopp	player_GS
player_Markus-Schopp_A	player_Markus-Schopp	player_A
player_Markus-Schopp_GWA	player_Markus-Schopp	player_GWA
player_Markus-Schopp_HmA	player_Markus-Schopp	player_HmA
player_Markus-Schopp_RdA	player_Markus-Schopp	player_RdA
player_Markus-Schopp_A.90min	player_Markus-Schopp	player_A.90min
player_Devon-McTavish_Club	player_Devon-McTavish	player_Club
player_Devon-McTavish_POS	player_Devon-McTavish	player_POS
player_Devon-McTavish_GP	player_Devon-McTavish	player_GP
player_Devon-McTavish_GS	player_Devon-McTavish	player_GS
player_Devon-McTavish_A	player_Devon-McTavish	player_A
player_Devon-McTavish_GWA	player_Devon-McTavish	player_GWA
player_Devon-McTavish_HmA	player_Devon-McTavish	player_HmA
player_Devon-McTavish_RdA	player_Devon-McTavish	player_RdA
player_Devon-McTavish_A.90min	player_Devon-McTavish	player_A.90min
player_Lance-Watson_Club	player_Lance-Watson	player_Club
player_Lance-Watson_POS	player_Lance-Watson	player_POS
player_Lance-Watson_GP	player_Lance-Watson	player_GP
player_Lance-Watson_GS	player_Lance-Watson	player_GS
player_Lance-Watson_A	player_Lance-Watson	player_A
player_Lance-Watson_GWA	player_Lance-Watson	player_GWA
player_Lance-Watson_HmA	player_Lance-Watson	player_HmA
player_Lance-Watson_RdA	player_Lance-Watson	player_RdA
player_Lance-Watson_A.90min	player_Lance-Watson	player_A.90min
player_Tim-Ward_Club	player_Tim-Ward	player_Club
player_Tim-Ward_POS	player_Tim-Ward	player_POS
player_Tim-Ward_GP	player_Tim-Ward	player_GP
player_Tim-Ward_GS	player_Tim-Ward	player_GS
player_Tim-Ward_A	player_Tim-Ward	player_A
player_Tim-Ward_GWA	player_Tim-Ward	player_GWA
player_Tim-Ward_HmA	player_Tim-Ward	player_HmA
player_Tim-Ward_RdA	player_Tim-Ward	player_RdA
player_Tim-Ward_A.90min	player_Tim-Ward	player_A.90min
player_Tyson-Wahl_Club	player_Tyson-Wahl	player_Club
player_Tyson-Wahl_POS	player_Tyson-Wahl	player_POS
player_Tyson-Wahl_GP	player_Tyson-Wahl	player_GP
player_Tyson-Wahl_GS	player_Tyson-Wahl	player_GS
player_Tyson-Wahl_A	player_Tyson-Wahl	player_A
player_Tyson-Wahl_GWA	player_Tyson-Wahl	player_GWA
player_Tyson-Wahl_HmA	player_Tyson-Wahl	player_HmA
player_Tyson-Wahl_RdA	player_Tyson-Wahl	player_RdA
player_Tyson-Wahl_A.90min	player_Tyson-Wahl	player_A.90min
player_Adrian-Serioux_Club	player_Adrian-Serioux	player_Club
player_Adrian-Serioux_POS	player_Adrian-Serioux	player_POS
player_Adrian-Serioux_GP	player_Adrian-Serioux	player_GP
player_Adrian-Serioux_GS	player_Adrian-Serioux	player_GS
player_Adrian-Serioux_A	player_Adrian-Serioux	player_A
player_Adrian-Serioux_GWA	player_Adrian-Serioux	player_GWA
player_Adrian-Serioux_HmA	player_Adrian-Serioux	player_HmA
player_Adrian-Serioux_RdA	player_Adrian-Serioux	player_RdA
player_Adrian-Serioux_A.90min	player_Adrian-Serioux	player_A.90min
player_Brandon-Moss_Club	player_Brandon-Moss	player_Club
player_Brandon-Moss_POS	player_Brandon-Moss	player_POS
player_Brandon-Moss_GP	player_Brandon-Moss	player_GP
player_Brandon-Moss_GS	player_Brandon-Moss	player_GS
player_Brandon-Moss_A	player_Brandon-Moss	player_A
player_Brandon-Moss_GWA	player_Brandon-Moss	player_GWA
player_Brandon-Moss_HmA	player_Brandon-Moss	player_HmA
player_Brandon-Moss_RdA	player_Brandon-Moss	player_RdA
player_Brandon-Moss_A.90min	player_Brandon-Moss	player_A.90min
player_Marcos-Gonzalez_Club	player_Marcos-Gonzalez	player_Club
player_Marcos-Gonzalez_POS	player_Marcos-Gonzalez	player_POS
player_Marcos-Gonzalez_GP	player_Marcos-Gonzalez	player_GP
player_Marcos-Gonzalez_GS	player_Marcos-Gonzalez	player_GS
player_Marcos-Gonzalez_A	player_Marcos-Gonzalez	player_A
player_Marcos-Gonzalez_GWA	player_Marcos-Gonzalez	player_GWA
player_Marcos-Gonzalez_HmA	player_Marcos-Gonzalez	player_HmA
player_Marcos-Gonzalez_RdA	player_Marcos-Gonzalez	player_RdA
player_Marcos-Gonzalez_A.90min	player_Marcos-Gonzalez	player_A.90min
player_James-Riley_Club	player_James-Riley	player_Club
player_James-Riley_POS	player_James-Riley	player_POS
player_James-Riley_GP	player_James-Riley	player_GP
player_James-Riley_GS	player_James-Riley	player_GS
player_James-Riley_A	player_James-Riley	player_A
player_James-Riley_GWA	player_James-Riley	player_GWA
player_James-Riley_HmA	player_James-Riley	player_HmA
player_James-Riley_RdA	player_James-Riley	player_RdA
player_James-Riley_A.90min	player_James-Riley	player_A.90min
player_Dasan-Robinson_Club	player_Dasan-Robinson	player_Club
player_Dasan-Robinson_POS	player_Dasan-Robinson	player_POS
player_Dasan-Robinson_GP	player_Dasan-Robinson	player_GP
player_Dasan-Robinson_GS	player_Dasan-Robinson	player_GS
player_Dasan-Robinson_A	player_Dasan-Robinson	player_A
player_Dasan-Robinson_GWA	player_Dasan-Robinson	player_GWA
player_Dasan-Robinson_HmA	player_Dasan-Robinson	player_HmA
player_Dasan-Robinson_RdA	player_Dasan-Robinson	player_RdA
player_Dasan-Robinson_A.90min	player_Dasan-Robinson	player_A.90min
player_Ryan-Cochrane_Club	player_Ryan-Cochrane	player_Club
player_Ryan-Cochrane_POS	player_Ryan-Cochrane	player_POS
player_Ryan-Cochrane_GP	player_Ryan-Cochrane	player_GP
player_Ryan-Cochrane_GS	player_Ryan-Cochrane	player_GS
player_Ryan-Cochrane_A	player_Ryan-Cochrane	player_A
player_Ryan-Cochrane_GWA	player_Ryan-Cochrane	player_GWA
player_Ryan-Cochrane_HmA	player_Ryan-Cochrane	player_HmA
player_Ryan-Cochrane_RdA	player_Ryan-Cochrane	player_RdA
player_Ryan-Cochrane_A.90min	player_Ryan-Cochrane	player_A.90min
player_Brad-Evans_Club	player_Brad-Evans	player_Club
player_Brad-Evans_POS	player_Brad-Evans	player_POS
player_Brad-Evans_GP	player_Brad-Evans	player_GP
player_Brad-Evans_GS	player_Brad-Evans	player_GS
player_Brad-Evans_A	player_Brad-Evans	player_A
player_Brad-Evans_GWA	player_Brad-Evans	player_GWA
player_Brad-Evans_HmA	player_Brad-Evans	player_HmA
player_Brad-Evans_RdA	player_Brad-Evans	player_RdA
player_Brad-Evans_A.90min	player_Brad-Evans	player_A.90min
player_Wilman-Conde_Club	player_Wilman-Conde	player_Club
player_Wilman-Conde_POS	player_Wilman-Conde	player_POS
player_Wilman-Conde_GP	player_Wilman-Conde	player_GP
player_Wilman-Conde_GS	player_Wilman-Conde	player_GS
player_Wilman-Conde_A	player_Wilman-Conde	player_A
player_Wilman-Conde_GWA	player_Wilman-Conde	player_GWA
player_Wilman-Conde_HmA	player_Wilman-Conde	player_HmA
player_Wilman-Conde_RdA	player_Wilman-Conde	player_RdA
player_Wilman-Conde_A.90min	player_Wilman-Conde	player_A.90min
player_Robbie-Rogers_Club	player_Robbie-Rogers	player_Club
player_Robbie-Rogers_POS	player_Robbie-Rogers	player_POS
player_Robbie-Rogers_GP	player_Robbie-Rogers	player_GP
player_Robbie-Rogers_GS	player_Robbie-Rogers	player_GS
player_Robbie-Rogers_A	player_Robbie-Rogers	player_A
player_Robbie-Rogers_GWA	player_Robbie-Rogers	player_GWA
player_Robbie-Rogers_HmA	player_Robbie-Rogers	player_HmA
player_Robbie-Rogers_RdA	player_Robbie-Rogers	player_RdA
player_Robbie-Rogers_A.90min	player_Robbie-Rogers	player_A.90min
player_Hunter-Freeman_Club	player_Hunter-Freeman	player_Club
player_Hunter-Freeman_POS	player_Hunter-Freeman	player_POS
player_Hunter-Freeman_GP	player_Hunter-Freeman	player_GP
player_Hunter-Freeman_GS	player_Hunter-Freeman	player_GS
player_Hunter-Freeman_A	player_Hunter-Freeman	player_A
player_Hunter-Freeman_GWA	player_Hunter-Freeman	player_GWA
player_Hunter-Freeman_HmA	player_Hunter-Freeman	player_HmA
player_Hunter-Freeman_RdA	player_Hunter-Freeman	player_RdA
player_Hunter-Freeman_A.90min	player_Hunter-Freeman	player_A.90min
player_Andrew-Boyens_Club	player_Andrew-Boyens	player_Club
player_Andrew-Boyens_POS	player_Andrew-Boyens	player_POS
player_Andrew-Boyens_GP	player_Andrew-Boyens	player_GP
player_Andrew-Boyens_GS	player_Andrew-Boyens	player_GS
player_Andrew-Boyens_A	player_Andrew-Boyens	player_A
player_Andrew-Boyens_GWA	player_Andrew-Boyens	player_GWA
player_Andrew-Boyens_HmA	player_Andrew-Boyens	player_HmA
player_Andrew-Boyens_RdA	player_Andrew-Boyens	player_RdA
player_Andrew-Boyens_A.90min	player_Andrew-Boyens	player_A.90min
player_Joshua-Gros_Club	player_Joshua-Gros	player_Club
player_Joshua-Gros_POS	player_Joshua-Gros	player_POS
player_Joshua-Gros_GP	player_Joshua-Gros	player_GP
player_Joshua-Gros_GS	player_Joshua-Gros	player_GS
player_Joshua-Gros_A	player_Joshua-Gros	player_A
player_Joshua-Gros_GWA	player_Joshua-Gros	player_GWA
player_Joshua-Gros_HmA	player_Joshua-Gros	player_HmA
player_Joshua-Gros_RdA	player_Joshua-Gros	player_RdA
player_Joshua-Gros_A.90min	player_Joshua-Gros	player_A.90min
player_Danny-O'Rourke_Club	player_Danny-O'Rourke	player_Club
player_Danny-O'Rourke_POS	player_Danny-O'Rourke	player_POS
player_Danny-O'Rourke_GP	player_Danny-O'Rourke	player_GP
player_Danny-O'Rourke_GS	player_Danny-O'Rourke	player_GS
player_Danny-O'Rourke_A	player_Danny-O'Rourke	player_A
player_Danny-O'Rourke_GWA	player_Danny-O'Rourke	player_GWA
player_Danny-O'Rourke_HmA	player_Danny-O'Rourke	player_HmA
player_Danny-O'Rourke_RdA	player_Danny-O'Rourke	player_RdA
player_Danny-O'Rourke_A.90min	player_Danny-O'Rourke	player_A.90min
player_Daniel-Woolard_Club	player_Daniel-Woolard	player_Club
player_Daniel-Woolard_POS	player_Daniel-Woolard	player_POS
player_Daniel-Woolard_GP	player_Daniel-Woolard	player_GP
player_Daniel-Woolard_GS	player_Daniel-Woolard	player_GS
player_Daniel-Woolard_A	player_Daniel-Woolard	player_A
player_Daniel-Woolard_GWA	player_Daniel-Woolard	player_GWA
player_Daniel-Woolard_HmA	player_Daniel-Woolard	player_HmA
player_Daniel-Woolard_RdA	player_Daniel-Woolard	player_RdA
player_Daniel-Woolard_A.90min	player_Daniel-Woolard	player_A.90min
player_Erik-Hort_Club	player_Erik-Hort	player_Club
player_Erik-Hort_POS	player_Erik-Hort	player_POS
player_Erik-Hort_GP	player_Erik-Hort	player_GP
player_Erik-Hort_GS	player_Erik-Hort	player_GS
player_Erik-Hort_A	player_Erik-Hort	player_A
player_Erik-Hort_GWA	player_Erik-Hort	player_GWA
player_Erik-Hort_HmA	player_Erik-Hort	player_HmA
player_Erik-Hort_RdA	player_Erik-Hort	player_RdA
player_Erik-Hort_A.90min	player_Erik-Hort	player_A.90min
player_Andrew-Daniels_Club	player_Andrew-Daniels	player_Club
player_Andrew-Daniels_POS	player_Andrew-Daniels	player_POS
player_Andrew-Daniels_GP	player_Andrew-Daniels	player_GP
player_Andrew-Daniels_GS	player_Andrew-Daniels	player_GS
player_Andrew-Daniels_A	player_Andrew-Daniels	player_A
player_Andrew-Daniels_GWA	player_Andrew-Daniels	player_GWA
player_Andrew-Daniels_HmA	player_Andrew-Daniels	player_HmA
player_Andrew-Daniels_RdA	player_Andrew-Daniels	player_RdA
player_Andrew-Daniels_A.90min	player_Andrew-Daniels	player_A.90min
player_Hugh-MacDonald_Club	player_Hugh-MacDonald	player_Club
player_Hugh-MacDonald_POS	player_Hugh-MacDonald	player_POS
player_Hugh-MacDonald_GP	player_Hugh-MacDonald	player_GP
player_Hugh-MacDonald_GS	player_Hugh-MacDonald	player_GS
player_Hugh-MacDonald_A	player_Hugh-MacDonald	player_A
player_Hugh-MacDonald_GWA	player_Hugh-MacDonald	player_GWA
player_Hugh-MacDonald_HmA	player_Hugh-MacDonald	player_HmA
player_Hugh-MacDonald_RdA	player_Hugh-MacDonald	player_RdA
player_Hugh-MacDonald_A.90min	player_Hugh-MacDonald	player_A.90min
player_Stephen-Lumley_Club	player_Stephen-Lumley	player_Club
player_Stephen-Lumley_POS	player_Stephen-Lumley	player_POS
player_Stephen-Lumley_GP	player_Stephen-Lumley	player_GP
player_Stephen-Lumley_GS	player_Stephen-Lumley	player_GS
player_Stephen-Lumley_A	player_Stephen-Lumley	player_A
player_Stephen-Lumley_GWA	player_Stephen-Lumley	player_GWA
player_Stephen-Lumley_HmA	player_Stephen-Lumley	player_HmA
player_Stephen-Lumley_RdA	player_Stephen-Lumley	player_RdA
player_Stephen-Lumley_A.90min	player_Stephen-Lumley	player_A.90min
player_Eric-Ebert_Club	player_Eric-Ebert	player_Club
player_Eric-Ebert_POS	player_Eric-Ebert	player_POS
player_Eric-Ebert_GP	player_Eric-Ebert	player_GP
player_Eric-Ebert_GS	player_Eric-Ebert	player_GS
player_Eric-Ebert_A	player_Eric-Ebert	player_A
player_Eric-Ebert_GWA	player_Eric-Ebert	player_GWA
player_Eric-Ebert_HmA	player_Eric-Ebert	player_HmA
player_Eric-Ebert_RdA	player_Eric-Ebert	player_RdA
player_Eric-Ebert_A.90min	player_Eric-Ebert	player_A.90min
player_Amaechi-Igwe_Club	player_Amaechi-Igwe	player_Club
player_Amaechi-Igwe_POS	player_Amaechi-Igwe	player_POS
player_Amaechi-Igwe_GP	player_Amaechi-Igwe	player_GP
player_Amaechi-Igwe_GS	player_Amaechi-Igwe	player_GS
player_Amaechi-Igwe_A	player_Amaechi-Igwe	player_A
player_Amaechi-Igwe_GWA	player_Amaechi-Igwe	player_GWA
player_Amaechi-Igwe_HmA	player_Amaechi-Igwe	player_HmA
player_Amaechi-Igwe_RdA	player_Amaechi-Igwe	player_RdA
player_Amaechi-Igwe_A.90min	player_Amaechi-Igwe	player_A.90min
player_Ben-Hunter_Club	player_Ben-Hunter	player_Club
player_Ben-Hunter_POS	player_Ben-Hunter	player_POS
player_Ben-Hunter_GP	player_Ben-Hunter	player_GP
player_Ben-Hunter_GS	player_Ben-Hunter	player_GS
player_Ben-Hunter_A	player_Ben-Hunter	player_A
player_Ben-Hunter_GWA	player_Ben-Hunter	player_GWA
player_Ben-Hunter_HmA	player_Ben-Hunter	player_HmA
player_Ben-Hunter_RdA	player_Ben-Hunter	player_RdA
player_Ben-Hunter_A.90min	player_Ben-Hunter	player_A.90min
player_Kyle-Helton_Club	player_Kyle-Helton	player_Club
player_Kyle-Helton_POS	player_Kyle-Helton	player_POS
player_Kyle-Helton_GP	player_Kyle-Helton	player_GP
player_Kyle-Helton_GS	player_Kyle-Helton	player_GS
player_Kyle-Helton_A	player_Kyle-Helton	player_A
player_Kyle-Helton_GWA	player_Kyle-Helton	player_GWA
player_Kyle-Helton_HmA	player_Kyle-Helton	player_HmA
player_Kyle-Helton_RdA	player_Kyle-Helton	player_RdA
player_Kyle-Helton_A.90min	player_Kyle-Helton	player_A.90min
player_Nana-Attakora_Club	player_Nana-Attakora	player_Club
player_Nana-Attakora_POS	player_Nana-Attakora	player_POS
player_Nana-Attakora_GP	player_Nana-Attakora	player_GP
player_Nana-Attakora_GS	player_Nana-Attakora	player_GS
player_Nana-Attakora_A	player_Nana-Attakora	player_A
player_Nana-Attakora_GWA	player_Nana-Attakora	player_GWA
player_Nana-Attakora_HmA	player_Nana-Attakora	player_HmA
player_Nana-Attakora_RdA	player_Nana-Attakora	player_RdA
player_Nana-Attakora_A.90min	player_Nana-Attakora	player_A.90min
player_Andrei-Pacheco_Club	player_Andrei-Pacheco	player_Club
player_Andrei-Pacheco_POS	player_Andrei-Pacheco	player_POS
player_Andrei-Pacheco_GP	player_Andrei-Pacheco	player_GP
player_Andrei-Pacheco_GS	player_Andrei-Pacheco	player_GS
player_Andrei-Pacheco_A	player_Andrei-Pacheco	player_A
player_Andrei-Pacheco_GWA	player_Andrei-Pacheco	player_GWA
player_Andrei-Pacheco_HmA	player_Andrei-Pacheco	player_HmA
player_Andrei-Pacheco_RdA	player_Andrei-Pacheco	player_RdA
player_Andrei-Pacheco_A.90min	player_Andrei-Pacheco	player_A.90min
player_Osei-Telesford_Club	player_Osei-Telesford	player_Club
player_Osei-Telesford_POS	player_Osei-Telesford	player_POS
player_Osei-Telesford_GP	player_Osei-Telesford	player_GP
player_Osei-Telesford_GS	player_Osei-Telesford	player_GS
player_Osei-Telesford_A	player_Osei-Telesford	player_A
player_Osei-Telesford_GWA	player_Osei-Telesford	player_GWA
player_Osei-Telesford_HmA	player_Osei-Telesford	player_HmA
player_Osei-Telesford_RdA	player_Osei-Telesford	player_RdA
player_Osei-Telesford_A.90min	player_Osei-Telesford	player_A.90min
player_Abdoulie-Mansally_Club	player_Abdoulie-Mansally	player_Club
player_Abdoulie-Mansally_POS	player_Abdoulie-Mansally	player_POS
player_Abdoulie-Mansally_GP	player_Abdoulie-Mansally	player_GP
player_Abdoulie-Mansally_GS	player_Abdoulie-Mansally	player_GS
player_Abdoulie-Mansally_A	player_Abdoulie-Mansally	player_A
player_Abdoulie-Mansally_GWA	player_Abdoulie-Mansally	player_GWA
player_Abdoulie-Mansally_HmA	player_Abdoulie-Mansally	player_HmA
player_Abdoulie-Mansally_RdA	player_Abdoulie-Mansally	player_RdA
player_Abdoulie-Mansally_A.90min	player_Abdoulie-Mansally	player_A.90min
player_Ryan-Junge_Club	player_Ryan-Junge	player_Club
player_Ryan-Junge_POS	player_Ryan-Junge	player_POS
player_Ryan-Junge_GP	player_Ryan-Junge	player_GP
player_Ryan-Junge_GS	player_Ryan-Junge	player_GS
player_Ryan-Junge_A	player_Ryan-Junge	player_A
player_Ryan-Junge_GWA	player_Ryan-Junge	player_GWA
player_Ryan-Junge_HmA	player_Ryan-Junge	player_HmA
player_Ryan-Junge_RdA	player_Ryan-Junge	player_RdA
player_Ryan-Junge_A.90min	player_Ryan-Junge	player_A.90min
player_Anthony-Wallace_Club	player_Anthony-Wallace	player_Club
player_Anthony-Wallace_POS	player_Anthony-Wallace	player_POS
player_Anthony-Wallace_GP	player_Anthony-Wallace	player_GP
player_Anthony-Wallace_GS	player_Anthony-Wallace	player_GS
player_Anthony-Wallace_A	player_Anthony-Wallace	player_A
player_Anthony-Wallace_GWA	player_Anthony-Wallace	player_GWA
player_Anthony-Wallace_HmA	player_Anthony-Wallace	player_HmA
player_Anthony-Wallace_RdA	player_Anthony-Wallace	player_RdA
player_Anthony-Wallace_A.90min	player_Anthony-Wallace	player_A.90min
player_Andrew-Peterson_Club	player_Andrew-Peterson	player_Club
player_Andrew-Peterson_POS	player_Andrew-Peterson	player_POS
player_Andrew-Peterson_GP	player_Andrew-Peterson	player_GP
player_Andrew-Peterson_GS	player_Andrew-Peterson	player_GS
player_Andrew-Peterson_A	player_Andrew-Peterson	player_A
player_Andrew-Peterson_GWA	player_Andrew-Peterson	player_GWA
player_Andrew-Peterson_HmA	player_Andrew-Peterson	player_HmA
player_Andrew-Peterson_RdA	player_Andrew-Peterson	player_RdA
player_Andrew-Peterson_A.90min	player_Andrew-Peterson	player_A.90min
player_Aaron-Hohlbein_Club	player_Aaron-Hohlbein	player_Club
player_Aaron-Hohlbein_POS	player_Aaron-Hohlbein	player_POS
player_Aaron-Hohlbein_GP	player_Aaron-Hohlbein	player_GP
player_Aaron-Hohlbein_GS	player_Aaron-Hohlbein	player_GS
player_Aaron-Hohlbein_A	player_Aaron-Hohlbein	player_A
player_Aaron-Hohlbein_GWA	player_Aaron-Hohlbein	player_GWA
player_Aaron-Hohlbein_HmA	player_Aaron-Hohlbein	player_HmA
player_Aaron-Hohlbein_RdA	player_Aaron-Hohlbein	player_RdA
player_Aaron-Hohlbein_A.90min	player_Aaron-Hohlbein	player_A.90min
player_Miguel-Canizalez_Club	player_Miguel-Canizalez	player_Club
player_Miguel-Canizalez_POS	player_Miguel-Canizalez	player_POS
player_Miguel-Canizalez_GP	player_Miguel-Canizalez	player_GP
player_Miguel-Canizalez_GS	player_Miguel-Canizalez	player_GS
player_Miguel-Canizalez_A	player_Miguel-Canizalez	player_A
player_Miguel-Canizalez_GWA	player_Miguel-Canizalez	player_GWA
player_Miguel-Canizalez_HmA	player_Miguel-Canizalez	player_HmA
player_Miguel-Canizalez_RdA	player_Miguel-Canizalez	player_RdA
player_Miguel-Canizalez_A.90min	player_Miguel-Canizalez	player_A.90min
player_Marco-Reda_Club	player_Marco-Reda	player_Club
player_Marco-Reda_POS	player_Marco-Reda	player_POS
player_Marco-Reda_GP	player_Marco-Reda	player_GP
player_Marco-Reda_GS	player_Marco-Reda	player_GS
player_Marco-Reda_A	player_Marco-Reda	player_A
player_Marco-Reda_GWA	player_Marco-Reda	player_GWA
player_Marco-Reda_HmA	player_Marco-Reda	player_HmA
player_Marco-Reda_RdA	player_Marco-Reda	player_RdA
player_Marco-Reda_A.90min	player_Marco-Reda	player_A.90min
player_Adam-Braz_Club	player_Adam-Braz	player_Club
player_Adam-Braz_POS	player_Adam-Braz	player_POS
player_Adam-Braz_GP	player_Adam-Braz	player_GP
player_Adam-Braz_GS	player_Adam-Braz	player_GS
player_Adam-Braz_A	player_Adam-Braz	player_A
player_Adam-Braz_GWA	player_Adam-Braz	player_GWA
player_Adam-Braz_HmA	player_Adam-Braz	player_HmA
player_Adam-Braz_RdA	player_Adam-Braz	player_RdA
player_Adam-Braz_A.90min	player_Adam-Braz	player_A.90min
player_Bakary-Soumare_Club	player_Bakary-Soumare	player_Club
player_Bakary-Soumare_POS	player_Bakary-Soumare	player_POS
player_Bakary-Soumare_GP	player_Bakary-Soumare	player_GP
player_Bakary-Soumare_GS	player_Bakary-Soumare	player_GS
player_Bakary-Soumare_A	player_Bakary-Soumare	player_A
player_Bakary-Soumare_GWA	player_Bakary-Soumare	player_GWA
player_Bakary-Soumare_HmA	player_Bakary-Soumare	player_HmA
player_Bakary-Soumare_RdA	player_Bakary-Soumare	player_RdA
player_Bakary-Soumare_A.90min	player_Bakary-Soumare	player_A.90min
player_Wells-Thompson_Club	player_Wells-Thompson	player_Club
player_Wells-Thompson_POS	player_Wells-Thompson	player_POS
player_Wells-Thompson_GP	player_Wells-Thompson	player_GP
player_Wells-Thompson_GS	player_Wells-Thompson	player_GS
player_Wells-Thompson_A	player_Wells-Thompson	player_A
player_Wells-Thompson_GWA	player_Wells-Thompson	player_GWA
player_Wells-Thompson_HmA	player_Wells-Thompson	player_HmA
player_Wells-Thompson_RdA	player_Wells-Thompson	player_RdA
player_Wells-Thompson_A.90min	player_Wells-Thompson	player_A.90min
player_Todd-Dunivant_Club	player_Todd-Dunivant	player_Club
player_Todd-Dunivant_POS	player_Todd-Dunivant	player_POS
player_Todd-Dunivant_GP	player_Todd-Dunivant	player_GP
player_Todd-Dunivant_GS	player_Todd-Dunivant	player_GS
player_Todd-Dunivant_A	player_Todd-Dunivant	player_A
player_Todd-Dunivant_GWA	player_Todd-Dunivant	player_GWA
player_Todd-Dunivant_HmA	player_Todd-Dunivant	player_HmA
player_Todd-Dunivant_RdA	player_Todd-Dunivant	player_RdA
player_Todd-Dunivant_A.90min	player_Todd-Dunivant	player_A.90min
player_Jim-Brennan_Club	player_Jim-Brennan	player_Club
player_Jim-Brennan_POS	player_Jim-Brennan	player_POS
player_Jim-Brennan_GP	player_Jim-Brennan	player_GP
player_Jim-Brennan_GS	player_Jim-Brennan	player_GS
player_Jim-Brennan_A	player_Jim-Brennan	player_A
player_Jim-Brennan_GWA	player_Jim-Brennan	player_GWA
player_Jim-Brennan_HmA	player_Jim-Brennan	player_HmA
player_Jim-Brennan_RdA	player_Jim-Brennan	player_RdA
player_Jim-Brennan_A.90min	player_Jim-Brennan	player_A.90min
