player_Curt-Onalfo_Club	player_Curt-Onalfo	player_Club
player_Curt-Onalfo_POS	player_Curt-Onalfo	player_POS
player_Curt-Onalfo_GP	player_Curt-Onalfo	player_GP
player_Curt-Onalfo_GS	player_Curt-Onalfo	player_GS
player_Curt-Onalfo_A	player_Curt-Onalfo	player_A
player_Curt-Onalfo_GWA	player_Curt-Onalfo	player_GWA
player_Curt-Onalfo_HmA	player_Curt-Onalfo	player_HmA
player_Curt-Onalfo_RdA	player_Curt-Onalfo	player_RdA
player_Curt-Onalfo_A.90min	player_Curt-Onalfo	player_A.90min
player_Manny-Motajo_Club	player_Manny-Motajo	player_Club
player_Manny-Motajo_POS	player_Manny-Motajo	player_POS
player_Manny-Motajo_GP	player_Manny-Motajo	player_GP
player_Manny-Motajo_GS	player_Manny-Motajo	player_GS
player_Manny-Motajo_A	player_Manny-Motajo	player_A
player_Manny-Motajo_GWA	player_Manny-Motajo	player_GWA
player_Manny-Motajo_HmA	player_Manny-Motajo	player_HmA
player_Manny-Motajo_RdA	player_Manny-Motajo	player_RdA
player_Manny-Motajo_A.90min	player_Manny-Motajo	player_A.90min
player_Scott-Cannon_Club	player_Scott-Cannon	player_Club
player_Scott-Cannon_POS	player_Scott-Cannon	player_POS
player_Scott-Cannon_GP	player_Scott-Cannon	player_GP
player_Scott-Cannon_GS	player_Scott-Cannon	player_GS
player_Scott-Cannon_A	player_Scott-Cannon	player_A
player_Scott-Cannon_GWA	player_Scott-Cannon	player_GWA
player_Scott-Cannon_HmA	player_Scott-Cannon	player_HmA
player_Scott-Cannon_RdA	player_Scott-Cannon	player_RdA
player_Scott-Cannon_A.90min	player_Scott-Cannon	player_A.90min
player_Greg-Vanney_Club	player_Greg-Vanney	player_Club
player_Greg-Vanney_POS	player_Greg-Vanney	player_POS
player_Greg-Vanney_GP	player_Greg-Vanney	player_GP
player_Greg-Vanney_GS	player_Greg-Vanney	player_GS
player_Greg-Vanney_A	player_Greg-Vanney	player_A
player_Greg-Vanney_GWA	player_Greg-Vanney	player_GWA
player_Greg-Vanney_HmA	player_Greg-Vanney	player_HmA
player_Greg-Vanney_RdA	player_Greg-Vanney	player_RdA
player_Greg-Vanney_A.90min	player_Greg-Vanney	player_A.90min
player_Dan-Calichman_Club	player_Dan-Calichman	player_Club
player_Dan-Calichman_POS	player_Dan-Calichman	player_POS
player_Dan-Calichman_GP	player_Dan-Calichman	player_GP
player_Dan-Calichman_GS	player_Dan-Calichman	player_GS
player_Dan-Calichman_A	player_Dan-Calichman	player_A
player_Dan-Calichman_GWA	player_Dan-Calichman	player_GWA
player_Dan-Calichman_HmA	player_Dan-Calichman	player_HmA
player_Dan-Calichman_RdA	player_Dan-Calichman	player_RdA
player_Dan-Calichman_A.90min	player_Dan-Calichman	player_A.90min
player_Denis-Hamlett_Club	player_Denis-Hamlett	player_Club
player_Denis-Hamlett_POS	player_Denis-Hamlett	player_POS
player_Denis-Hamlett_GP	player_Denis-Hamlett	player_GP
player_Denis-Hamlett_GS	player_Denis-Hamlett	player_GS
player_Denis-Hamlett_A	player_Denis-Hamlett	player_A
player_Denis-Hamlett_GWA	player_Denis-Hamlett	player_GWA
player_Denis-Hamlett_HmA	player_Denis-Hamlett	player_HmA
player_Denis-Hamlett_RdA	player_Denis-Hamlett	player_RdA
player_Denis-Hamlett_A.90min	player_Denis-Hamlett	player_A.90min
player_Rafael-Amaya_Club	player_Rafael-Amaya	player_Club
player_Rafael-Amaya_POS	player_Rafael-Amaya	player_POS
player_Rafael-Amaya_GP	player_Rafael-Amaya	player_GP
player_Rafael-Amaya_GS	player_Rafael-Amaya	player_GS
player_Rafael-Amaya_A	player_Rafael-Amaya	player_A
player_Rafael-Amaya_GWA	player_Rafael-Amaya	player_GWA
player_Rafael-Amaya_HmA	player_Rafael-Amaya	player_HmA
player_Rafael-Amaya_RdA	player_Rafael-Amaya	player_RdA
player_Rafael-Amaya_A.90min	player_Rafael-Amaya	player_A.90min
player_Tayt-Ianni_Club	player_Tayt-Ianni	player_Club
player_Tayt-Ianni_POS	player_Tayt-Ianni	player_POS
player_Tayt-Ianni_GP	player_Tayt-Ianni	player_GP
player_Tayt-Ianni_GS	player_Tayt-Ianni	player_GS
player_Tayt-Ianni_A	player_Tayt-Ianni	player_A
player_Tayt-Ianni_GWA	player_Tayt-Ianni	player_GWA
player_Tayt-Ianni_HmA	player_Tayt-Ianni	player_HmA
player_Tayt-Ianni_RdA	player_Tayt-Ianni	player_RdA
player_Tayt-Ianni_A.90min	player_Tayt-Ianni	player_A.90min
player_Troy-Edwards_Club	player_Troy-Edwards	player_Club
player_Troy-Edwards_POS	player_Troy-Edwards	player_POS
player_Troy-Edwards_GP	player_Troy-Edwards	player_GP
player_Troy-Edwards_GS	player_Troy-Edwards	player_GS
player_Troy-Edwards_A	player_Troy-Edwards	player_A
player_Troy-Edwards_GWA	player_Troy-Edwards	player_GWA
player_Troy-Edwards_HmA	player_Troy-Edwards	player_HmA
player_Troy-Edwards_RdA	player_Troy-Edwards	player_RdA
player_Troy-Edwards_A.90min	player_Troy-Edwards	player_A.90min
player_Brad-Wilson_Club	player_Brad-Wilson	player_Club
player_Brad-Wilson_POS	player_Brad-Wilson	player_POS
player_Brad-Wilson_GP	player_Brad-Wilson	player_GP
player_Brad-Wilson_GS	player_Brad-Wilson	player_GS
player_Brad-Wilson_A	player_Brad-Wilson	player_A
player_Brad-Wilson_GWA	player_Brad-Wilson	player_GWA
player_Brad-Wilson_HmA	player_Brad-Wilson	player_HmA
player_Brad-Wilson_RdA	player_Brad-Wilson	player_RdA
player_Brad-Wilson_A.90min	player_Brad-Wilson	player_A.90min
player_Ian-Butterworth_Club	player_Ian-Butterworth	player_Club
player_Ian-Butterworth_POS	player_Ian-Butterworth	player_POS
player_Ian-Butterworth_GP	player_Ian-Butterworth	player_GP
player_Ian-Butterworth_GS	player_Ian-Butterworth	player_GS
player_Ian-Butterworth_A	player_Ian-Butterworth	player_A
player_Ian-Butterworth_GWA	player_Ian-Butterworth	player_GWA
player_Ian-Butterworth_HmA	player_Ian-Butterworth	player_HmA
player_Ian-Butterworth_RdA	player_Ian-Butterworth	player_RdA
player_Ian-Butterworth_A.90min	player_Ian-Butterworth	player_A.90min
player_Oscar-Draguicevich_Club	player_Oscar-Draguicevich	player_Club
player_Oscar-Draguicevich_POS	player_Oscar-Draguicevich	player_POS
player_Oscar-Draguicevich_GP	player_Oscar-Draguicevich	player_GP
player_Oscar-Draguicevich_GS	player_Oscar-Draguicevich	player_GS
player_Oscar-Draguicevich_A	player_Oscar-Draguicevich	player_A
player_Oscar-Draguicevich_GWA	player_Oscar-Draguicevich	player_GWA
player_Oscar-Draguicevich_HmA	player_Oscar-Draguicevich	player_HmA
player_Oscar-Draguicevich_RdA	player_Oscar-Draguicevich	player_RdA
player_Oscar-Draguicevich_A.90min	player_Oscar-Draguicevich	player_A.90min
player_Robin-Fraser_Club	player_Robin-Fraser	player_Club
player_Robin-Fraser_POS	player_Robin-Fraser	player_POS
player_Robin-Fraser_GP	player_Robin-Fraser	player_GP
player_Robin-Fraser_GS	player_Robin-Fraser	player_GS
player_Robin-Fraser_A	player_Robin-Fraser	player_A
player_Robin-Fraser_GWA	player_Robin-Fraser	player_GWA
player_Robin-Fraser_HmA	player_Robin-Fraser	player_HmA
player_Robin-Fraser_RdA	player_Robin-Fraser	player_RdA
player_Robin-Fraser_A.90min	player_Robin-Fraser	player_A.90min
player_Matt-Kmosko_Club	player_Matt-Kmosko	player_Club
player_Matt-Kmosko_POS	player_Matt-Kmosko	player_POS
player_Matt-Kmosko_GP	player_Matt-Kmosko	player_GP
player_Matt-Kmosko_GS	player_Matt-Kmosko	player_GS
player_Matt-Kmosko_A	player_Matt-Kmosko	player_A
player_Matt-Kmosko_GWA	player_Matt-Kmosko	player_GWA
player_Matt-Kmosko_HmA	player_Matt-Kmosko	player_HmA
player_Matt-Kmosko_RdA	player_Matt-Kmosko	player_RdA
player_Matt-Kmosko_A.90min	player_Matt-Kmosko	player_A.90min
player_Tim-Martin_Club	player_Tim-Martin	player_Club
player_Tim-Martin_POS	player_Tim-Martin	player_POS
player_Tim-Martin_GP	player_Tim-Martin	player_GP
player_Tim-Martin_GS	player_Tim-Martin	player_GS
player_Tim-Martin_A	player_Tim-Martin	player_A
player_Tim-Martin_GWA	player_Tim-Martin	player_GWA
player_Tim-Martin_HmA	player_Tim-Martin	player_HmA
player_Tim-Martin_RdA	player_Tim-Martin	player_RdA
player_Tim-Martin_A.90min	player_Tim-Martin	player_A.90min
player_Ezra-Hendrickson_Club	player_Ezra-Hendrickson	player_Club
player_Ezra-Hendrickson_POS	player_Ezra-Hendrickson	player_POS
player_Ezra-Hendrickson_GP	player_Ezra-Hendrickson	player_GP
player_Ezra-Hendrickson_GS	player_Ezra-Hendrickson	player_GS
player_Ezra-Hendrickson_A	player_Ezra-Hendrickson	player_A
player_Ezra-Hendrickson_GWA	player_Ezra-Hendrickson	player_GWA
player_Ezra-Hendrickson_HmA	player_Ezra-Hendrickson	player_HmA
player_Ezra-Hendrickson_RdA	player_Ezra-Hendrickson	player_RdA
player_Ezra-Hendrickson_A.90min	player_Ezra-Hendrickson	player_A.90min
player_Steve-Jolley_Club	player_Steve-Jolley	player_Club
player_Steve-Jolley_POS	player_Steve-Jolley	player_POS
player_Steve-Jolley_GP	player_Steve-Jolley	player_GP
player_Steve-Jolley_GS	player_Steve-Jolley	player_GS
player_Steve-Jolley_A	player_Steve-Jolley	player_A
player_Steve-Jolley_GWA	player_Steve-Jolley	player_GWA
player_Steve-Jolley_HmA	player_Steve-Jolley	player_HmA
player_Steve-Jolley_RdA	player_Steve-Jolley	player_RdA
player_Steve-Jolley_A.90min	player_Steve-Jolley	player_A.90min
player_Tahj-Jakins_Club	player_Tahj-Jakins	player_Club
player_Tahj-Jakins_POS	player_Tahj-Jakins	player_POS
player_Tahj-Jakins_GP	player_Tahj-Jakins	player_GP
player_Tahj-Jakins_GS	player_Tahj-Jakins	player_GS
player_Tahj-Jakins_A	player_Tahj-Jakins	player_A
player_Tahj-Jakins_GWA	player_Tahj-Jakins	player_GWA
player_Tahj-Jakins_HmA	player_Tahj-Jakins	player_HmA
player_Tahj-Jakins_RdA	player_Tahj-Jakins	player_RdA
player_Tahj-Jakins_A.90min	player_Tahj-Jakins	player_A.90min
player_John-Doyle_Club	player_John-Doyle	player_Club
player_John-Doyle_POS	player_John-Doyle	player_POS
player_John-Doyle_GP	player_John-Doyle	player_GP
player_John-Doyle_GS	player_John-Doyle	player_GS
player_John-Doyle_A	player_John-Doyle	player_A
player_John-Doyle_GWA	player_John-Doyle	player_GWA
player_John-Doyle_HmA	player_John-Doyle	player_HmA
player_John-Doyle_RdA	player_John-Doyle	player_RdA
player_John-Doyle_A.90min	player_John-Doyle	player_A.90min
player_Mark-Semioli_Club	player_Mark-Semioli	player_Club
player_Mark-Semioli_POS	player_Mark-Semioli	player_POS
player_Mark-Semioli_GP	player_Mark-Semioli	player_GP
player_Mark-Semioli_GS	player_Mark-Semioli	player_GS
player_Mark-Semioli_A	player_Mark-Semioli	player_A
player_Mark-Semioli_GWA	player_Mark-Semioli	player_GWA
player_Mark-Semioli_HmA	player_Mark-Semioli	player_HmA
player_Mark-Semioli_RdA	player_Mark-Semioli	player_RdA
player_Mark-Semioli_A.90min	player_Mark-Semioli	player_A.90min
player_Steve-Trittschuh_Club	player_Steve-Trittschuh	player_Club
player_Steve-Trittschuh_POS	player_Steve-Trittschuh	player_POS
player_Steve-Trittschuh_GP	player_Steve-Trittschuh	player_GP
player_Steve-Trittschuh_GS	player_Steve-Trittschuh	player_GS
player_Steve-Trittschuh_A	player_Steve-Trittschuh	player_A
player_Steve-Trittschuh_GWA	player_Steve-Trittschuh	player_GWA
player_Steve-Trittschuh_HmA	player_Steve-Trittschuh	player_HmA
player_Steve-Trittschuh_RdA	player_Steve-Trittschuh	player_RdA
player_Steve-Trittschuh_A.90min	player_Steve-Trittschuh	player_A.90min
player_Peter-Lak_Club	player_Peter-Lak	player_Club
player_Peter-Lak_POS	player_Peter-Lak	player_POS
player_Peter-Lak_GP	player_Peter-Lak	player_GP
player_Peter-Lak_GS	player_Peter-Lak	player_GS
player_Peter-Lak_A	player_Peter-Lak	player_A
player_Peter-Lak_GWA	player_Peter-Lak	player_GWA
player_Peter-Lak_HmA	player_Peter-Lak	player_HmA
player_Peter-Lak_RdA	player_Peter-Lak	player_RdA
player_Peter-Lak_A.90min	player_Peter-Lak	player_A.90min
player_Jose-Vasquez_Club	player_Jose-Vasquez	player_Club
player_Jose-Vasquez_POS	player_Jose-Vasquez	player_POS
player_Jose-Vasquez_GP	player_Jose-Vasquez	player_GP
player_Jose-Vasquez_GS	player_Jose-Vasquez	player_GS
player_Jose-Vasquez_A	player_Jose-Vasquez	player_A
player_Jose-Vasquez_GWA	player_Jose-Vasquez	player_GWA
player_Jose-Vasquez_HmA	player_Jose-Vasquez	player_HmA
player_Jose-Vasquez_RdA	player_Jose-Vasquez	player_RdA
player_Jose-Vasquez_A.90min	player_Jose-Vasquez	player_A.90min
player_Chris-Martinez_Club	player_Chris-Martinez	player_Club
player_Chris-Martinez_POS	player_Chris-Martinez	player_POS
player_Chris-Martinez_GP	player_Chris-Martinez	player_GP
player_Chris-Martinez_GS	player_Chris-Martinez	player_GS
player_Chris-Martinez_A	player_Chris-Martinez	player_A
player_Chris-Martinez_GWA	player_Chris-Martinez	player_GWA
player_Chris-Martinez_HmA	player_Chris-Martinez	player_HmA
player_Chris-Martinez_RdA	player_Chris-Martinez	player_RdA
player_Chris-Martinez_A.90min	player_Chris-Martinez	player_A.90min
player_Troy-Dayak_Club	player_Troy-Dayak	player_Club
player_Troy-Dayak_POS	player_Troy-Dayak	player_POS
player_Troy-Dayak_GP	player_Troy-Dayak	player_GP
player_Troy-Dayak_GS	player_Troy-Dayak	player_GS
player_Troy-Dayak_A	player_Troy-Dayak	player_A
player_Troy-Dayak_GWA	player_Troy-Dayak	player_GWA
player_Troy-Dayak_HmA	player_Troy-Dayak	player_HmA
player_Troy-Dayak_RdA	player_Troy-Dayak	player_RdA
player_Troy-Dayak_A.90min	player_Troy-Dayak	player_A.90min
player_Paul-Caligiuri_Club	player_Paul-Caligiuri	player_Club
player_Paul-Caligiuri_POS	player_Paul-Caligiuri	player_POS
player_Paul-Caligiuri_GP	player_Paul-Caligiuri	player_GP
player_Paul-Caligiuri_GS	player_Paul-Caligiuri	player_GS
player_Paul-Caligiuri_A	player_Paul-Caligiuri	player_A
player_Paul-Caligiuri_GWA	player_Paul-Caligiuri	player_GWA
player_Paul-Caligiuri_HmA	player_Paul-Caligiuri	player_HmA
player_Paul-Caligiuri_RdA	player_Paul-Caligiuri	player_RdA
player_Paul-Caligiuri_A.90min	player_Paul-Caligiuri	player_A.90min
player_Richard-Gough_Club	player_Richard-Gough	player_Club
player_Richard-Gough_POS	player_Richard-Gough	player_POS
player_Richard-Gough_GP	player_Richard-Gough	player_GP
player_Richard-Gough_GS	player_Richard-Gough	player_GS
player_Richard-Gough_A	player_Richard-Gough	player_A
player_Richard-Gough_GWA	player_Richard-Gough	player_GWA
player_Richard-Gough_HmA	player_Richard-Gough	player_HmA
player_Richard-Gough_RdA	player_Richard-Gough	player_RdA
player_Richard-Gough_A.90min	player_Richard-Gough	player_A.90min
player_Ben-Parry_Club	player_Ben-Parry	player_Club
player_Ben-Parry_POS	player_Ben-Parry	player_POS
player_Ben-Parry_GP	player_Ben-Parry	player_GP
player_Ben-Parry_GS	player_Ben-Parry	player_GS
player_Ben-Parry_A	player_Ben-Parry	player_A
player_Ben-Parry_GWA	player_Ben-Parry	player_GWA
player_Ben-Parry_HmA	player_Ben-Parry	player_HmA
player_Ben-Parry_RdA	player_Ben-Parry	player_RdA
player_Ben-Parry_A.90min	player_Ben-Parry	player_A.90min
player_Andre-Nunley_Club	player_Andre-Nunley	player_Club
player_Andre-Nunley_POS	player_Andre-Nunley	player_POS
player_Andre-Nunley_GP	player_Andre-Nunley	player_GP
player_Andre-Nunley_GS	player_Andre-Nunley	player_GS
player_Andre-Nunley_A	player_Andre-Nunley	player_A
player_Andre-Nunley_GWA	player_Andre-Nunley	player_GWA
player_Andre-Nunley_HmA	player_Andre-Nunley	player_HmA
player_Andre-Nunley_RdA	player_Andre-Nunley	player_RdA
player_Andre-Nunley_A.90min	player_Andre-Nunley	player_A.90min
player_Tyrone-Marshall_Club	player_Tyrone-Marshall	player_Club
player_Tyrone-Marshall_POS	player_Tyrone-Marshall	player_POS
player_Tyrone-Marshall_GP	player_Tyrone-Marshall	player_GP
player_Tyrone-Marshall_GS	player_Tyrone-Marshall	player_GS
player_Tyrone-Marshall_A	player_Tyrone-Marshall	player_A
player_Tyrone-Marshall_GWA	player_Tyrone-Marshall	player_GWA
player_Tyrone-Marshall_HmA	player_Tyrone-Marshall	player_HmA
player_Tyrone-Marshall_RdA	player_Tyrone-Marshall	player_RdA
player_Tyrone-Marshall_A.90min	player_Tyrone-Marshall	player_A.90min
player_Vicente-Figueroa_Club	player_Vicente-Figueroa	player_Club
player_Vicente-Figueroa_POS	player_Vicente-Figueroa	player_POS
player_Vicente-Figueroa_GP	player_Vicente-Figueroa	player_GP
player_Vicente-Figueroa_GS	player_Vicente-Figueroa	player_GS
player_Vicente-Figueroa_A	player_Vicente-Figueroa	player_A
player_Vicente-Figueroa_GWA	player_Vicente-Figueroa	player_GWA
player_Vicente-Figueroa_HmA	player_Vicente-Figueroa	player_HmA
player_Vicente-Figueroa_RdA	player_Vicente-Figueroa	player_RdA
player_Vicente-Figueroa_A.90min	player_Vicente-Figueroa	player_A.90min
player_Tim-Weaver_Club	player_Tim-Weaver	player_Club
player_Tim-Weaver_POS	player_Tim-Weaver	player_POS
player_Tim-Weaver_GP	player_Tim-Weaver	player_GP
player_Tim-Weaver_GS	player_Tim-Weaver	player_GS
player_Tim-Weaver_A	player_Tim-Weaver	player_A
player_Tim-Weaver_GWA	player_Tim-Weaver	player_GWA
player_Tim-Weaver_HmA	player_Tim-Weaver	player_HmA
player_Tim-Weaver_RdA	player_Tim-Weaver	player_RdA
player_Tim-Weaver_A.90min	player_Tim-Weaver	player_A.90min
player_Adam-Frye_Club	player_Adam-Frye	player_Club
player_Adam-Frye_POS	player_Adam-Frye	player_POS
player_Adam-Frye_GP	player_Adam-Frye	player_GP
player_Adam-Frye_GS	player_Adam-Frye	player_GS
player_Adam-Frye_A	player_Adam-Frye	player_A
player_Adam-Frye_GWA	player_Adam-Frye	player_GWA
player_Adam-Frye_HmA	player_Adam-Frye	player_HmA
player_Adam-Frye_RdA	player_Adam-Frye	player_RdA
player_Adam-Frye_A.90min	player_Adam-Frye	player_A.90min
player_Joey-Martinez_Club	player_Joey-Martinez	player_Club
player_Joey-Martinez_POS	player_Joey-Martinez	player_POS
player_Joey-Martinez_GP	player_Joey-Martinez	player_GP
player_Joey-Martinez_GS	player_Joey-Martinez	player_GS
player_Joey-Martinez_A	player_Joey-Martinez	player_A
player_Joey-Martinez_GWA	player_Joey-Martinez	player_GWA
player_Joey-Martinez_HmA	player_Joey-Martinez	player_HmA
player_Joey-Martinez_RdA	player_Joey-Martinez	player_RdA
player_Joey-Martinez_A.90min	player_Joey-Martinez	player_A.90min
player_Jimmy-Conrad_Club	player_Jimmy-Conrad	player_Club
player_Jimmy-Conrad_POS	player_Jimmy-Conrad	player_POS
player_Jimmy-Conrad_GP	player_Jimmy-Conrad	player_GP
player_Jimmy-Conrad_GS	player_Jimmy-Conrad	player_GS
player_Jimmy-Conrad_A	player_Jimmy-Conrad	player_A
player_Jimmy-Conrad_GWA	player_Jimmy-Conrad	player_GWA
player_Jimmy-Conrad_HmA	player_Jimmy-Conrad	player_HmA
player_Jimmy-Conrad_RdA	player_Jimmy-Conrad	player_RdA
player_Jimmy-Conrad_A.90min	player_Jimmy-Conrad	player_A.90min
player_David-Vaudreuil_Club	player_David-Vaudreuil	player_Club
player_David-Vaudreuil_POS	player_David-Vaudreuil	player_POS
player_David-Vaudreuil_GP	player_David-Vaudreuil	player_GP
player_David-Vaudreuil_GS	player_David-Vaudreuil	player_GS
player_David-Vaudreuil_A	player_David-Vaudreuil	player_A
player_David-Vaudreuil_GWA	player_David-Vaudreuil	player_GWA
player_David-Vaudreuil_HmA	player_David-Vaudreuil	player_HmA
player_David-Vaudreuil_RdA	player_David-Vaudreuil	player_RdA
player_David-Vaudreuil_A.90min	player_David-Vaudreuil	player_A.90min
player_Gabe-Eastman_Club	player_Gabe-Eastman	player_Club
player_Gabe-Eastman_POS	player_Gabe-Eastman	player_POS
player_Gabe-Eastman_GP	player_Gabe-Eastman	player_GP
player_Gabe-Eastman_GS	player_Gabe-Eastman	player_GS
player_Gabe-Eastman_A	player_Gabe-Eastman	player_A
player_Gabe-Eastman_GWA	player_Gabe-Eastman	player_GWA
player_Gabe-Eastman_HmA	player_Gabe-Eastman	player_HmA
player_Gabe-Eastman_RdA	player_Gabe-Eastman	player_RdA
player_Gabe-Eastman_A.90min	player_Gabe-Eastman	player_A.90min
player_Jamie-Clark_Club	player_Jamie-Clark	player_Club
player_Jamie-Clark_POS	player_Jamie-Clark	player_POS
player_Jamie-Clark_GP	player_Jamie-Clark	player_GP
player_Jamie-Clark_GS	player_Jamie-Clark	player_GS
player_Jamie-Clark_A	player_Jamie-Clark	player_A
player_Jamie-Clark_GWA	player_Jamie-Clark	player_GWA
player_Jamie-Clark_HmA	player_Jamie-Clark	player_HmA
player_Jamie-Clark_RdA	player_Jamie-Clark	player_RdA
player_Jamie-Clark_A.90min	player_Jamie-Clark	player_A.90min
player_Danny-Califf_Club	player_Danny-Califf	player_Club
player_Danny-Califf_POS	player_Danny-Califf	player_POS
player_Danny-Califf_GP	player_Danny-Califf	player_GP
player_Danny-Califf_GS	player_Danny-Califf	player_GS
player_Danny-Califf_A	player_Danny-Califf	player_A
player_Danny-Califf_GWA	player_Danny-Califf	player_GWA
player_Danny-Califf_HmA	player_Danny-Califf	player_HmA
player_Danny-Califf_RdA	player_Danny-Califf	player_RdA
player_Danny-Califf_A.90min	player_Danny-Califf	player_A.90min
player_Lance-Key_Club	player_Lance-Key	player_Club
player_Lance-Key_POS	player_Lance-Key	player_POS
player_Lance-Key_GP	player_Lance-Key	player_GP
player_Lance-Key_GS	player_Lance-Key	player_GS
player_Lance-Key_A	player_Lance-Key	player_A
player_Lance-Key_GWA	player_Lance-Key	player_GWA
player_Lance-Key_HmA	player_Lance-Key	player_HmA
player_Lance-Key_RdA	player_Lance-Key	player_RdA
player_Lance-Key_A.90min	player_Lance-Key	player_A.90min
player_Ryan-Tinsley_Club	player_Ryan-Tinsley	player_Club
player_Ryan-Tinsley_POS	player_Ryan-Tinsley	player_POS
player_Ryan-Tinsley_GP	player_Ryan-Tinsley	player_GP
player_Ryan-Tinsley_GS	player_Ryan-Tinsley	player_GS
player_Ryan-Tinsley_A	player_Ryan-Tinsley	player_A
player_Ryan-Tinsley_GWA	player_Ryan-Tinsley	player_GWA
player_Ryan-Tinsley_HmA	player_Ryan-Tinsley	player_HmA
player_Ryan-Tinsley_RdA	player_Ryan-Tinsley	player_RdA
player_Ryan-Tinsley_A.90min	player_Ryan-Tinsley	player_A.90min
player_Scott-Vermillion_Club	player_Scott-Vermillion	player_Club
player_Scott-Vermillion_POS	player_Scott-Vermillion	player_POS
player_Scott-Vermillion_GP	player_Scott-Vermillion	player_GP
player_Scott-Vermillion_GS	player_Scott-Vermillion	player_GS
player_Scott-Vermillion_A	player_Scott-Vermillion	player_A
player_Scott-Vermillion_GWA	player_Scott-Vermillion	player_GWA
player_Scott-Vermillion_HmA	player_Scott-Vermillion	player_HmA
player_Scott-Vermillion_RdA	player_Scott-Vermillion	player_RdA
player_Scott-Vermillion_A.90min	player_Scott-Vermillion	player_A.90min
player_Alijohn-Utush_Club	player_Alijohn-Utush	player_Club
player_Alijohn-Utush_POS	player_Alijohn-Utush	player_POS
player_Alijohn-Utush_GP	player_Alijohn-Utush	player_GP
player_Alijohn-Utush_GS	player_Alijohn-Utush	player_GS
player_Alijohn-Utush_A	player_Alijohn-Utush	player_A
player_Alijohn-Utush_GWA	player_Alijohn-Utush	player_GWA
player_Alijohn-Utush_HmA	player_Alijohn-Utush	player_HmA
player_Alijohn-Utush_RdA	player_Alijohn-Utush	player_RdA
player_Alijohn-Utush_A.90min	player_Alijohn-Utush	player_A.90min
player_Alan-Woods_Club	player_Alan-Woods	player_Club
player_Alan-Woods_POS	player_Alan-Woods	player_POS
player_Alan-Woods_GP	player_Alan-Woods	player_GP
player_Alan-Woods_GS	player_Alan-Woods	player_GS
player_Alan-Woods_A	player_Alan-Woods	player_A
player_Alan-Woods_GWA	player_Alan-Woods	player_GWA
player_Alan-Woods_HmA	player_Alan-Woods	player_HmA
player_Alan-Woods_RdA	player_Alan-Woods	player_RdA
player_Alan-Woods_A.90min	player_Alan-Woods	player_A.90min
player_Seth-Trembly_Club	player_Seth-Trembly	player_Club
player_Seth-Trembly_POS	player_Seth-Trembly	player_POS
player_Seth-Trembly_GP	player_Seth-Trembly	player_GP
player_Seth-Trembly_GS	player_Seth-Trembly	player_GS
player_Seth-Trembly_A	player_Seth-Trembly	player_A
player_Seth-Trembly_GWA	player_Seth-Trembly	player_GWA
player_Seth-Trembly_HmA	player_Seth-Trembly	player_HmA
player_Seth-Trembly_RdA	player_Seth-Trembly	player_RdA
player_Seth-Trembly_A.90min	player_Seth-Trembly	player_A.90min
player_Craig-Waibel_Club	player_Craig-Waibel	player_Club
player_Craig-Waibel_POS	player_Craig-Waibel	player_POS
player_Craig-Waibel_GP	player_Craig-Waibel	player_GP
player_Craig-Waibel_GS	player_Craig-Waibel	player_GS
player_Craig-Waibel_A	player_Craig-Waibel	player_A
player_Craig-Waibel_GWA	player_Craig-Waibel	player_GWA
player_Craig-Waibel_HmA	player_Craig-Waibel	player_HmA
player_Craig-Waibel_RdA	player_Craig-Waibel	player_RdA
player_Craig-Waibel_A.90min	player_Craig-Waibel	player_A.90min
player_Wade-Barrett_Club	player_Wade-Barrett	player_Club
player_Wade-Barrett_POS	player_Wade-Barrett	player_POS
player_Wade-Barrett_GP	player_Wade-Barrett	player_GP
player_Wade-Barrett_GS	player_Wade-Barrett	player_GS
player_Wade-Barrett_A	player_Wade-Barrett	player_A
player_Wade-Barrett_GWA	player_Wade-Barrett	player_GWA
player_Wade-Barrett_HmA	player_Wade-Barrett	player_HmA
player_Wade-Barrett_RdA	player_Wade-Barrett	player_RdA
player_Wade-Barrett_A.90min	player_Wade-Barrett	player_A.90min
player_Wes-Hart_Club	player_Wes-Hart	player_Club
player_Wes-Hart_POS	player_Wes-Hart	player_POS
player_Wes-Hart_GP	player_Wes-Hart	player_GP
player_Wes-Hart_GS	player_Wes-Hart	player_GS
player_Wes-Hart_A	player_Wes-Hart	player_A
player_Wes-Hart_GWA	player_Wes-Hart	player_GWA
player_Wes-Hart_HmA	player_Wes-Hart	player_HmA
player_Wes-Hart_RdA	player_Wes-Hart	player_RdA
player_Wes-Hart_A.90min	player_Wes-Hart	player_A.90min
player_Keyeno-Thomas_Club	player_Keyeno-Thomas	player_Club
player_Keyeno-Thomas_POS	player_Keyeno-Thomas	player_POS
player_Keyeno-Thomas_GP	player_Keyeno-Thomas	player_GP
player_Keyeno-Thomas_GS	player_Keyeno-Thomas	player_GS
player_Keyeno-Thomas_A	player_Keyeno-Thomas	player_A
player_Keyeno-Thomas_GWA	player_Keyeno-Thomas	player_GWA
player_Keyeno-Thomas_HmA	player_Keyeno-Thomas	player_HmA
player_Keyeno-Thomas_RdA	player_Keyeno-Thomas	player_RdA
player_Keyeno-Thomas_A.90min	player_Keyeno-Thomas	player_A.90min
player_Steve-Shak_Club	player_Steve-Shak	player_Club
player_Steve-Shak_POS	player_Steve-Shak	player_POS
player_Steve-Shak_GP	player_Steve-Shak	player_GP
player_Steve-Shak_GS	player_Steve-Shak	player_GS
player_Steve-Shak_A	player_Steve-Shak	player_A
player_Steve-Shak_GWA	player_Steve-Shak	player_GWA
player_Steve-Shak_HmA	player_Steve-Shak	player_HmA
player_Steve-Shak_RdA	player_Steve-Shak	player_RdA
player_Steve-Shak_A.90min	player_Steve-Shak	player_A.90min
player_Ritchie-Kotschau_Club	player_Ritchie-Kotschau	player_Club
player_Ritchie-Kotschau_POS	player_Ritchie-Kotschau	player_POS
player_Ritchie-Kotschau_GP	player_Ritchie-Kotschau	player_GP
player_Ritchie-Kotschau_GS	player_Ritchie-Kotschau	player_GS
player_Ritchie-Kotschau_A	player_Ritchie-Kotschau	player_A
player_Ritchie-Kotschau_GWA	player_Ritchie-Kotschau	player_GWA
player_Ritchie-Kotschau_HmA	player_Ritchie-Kotschau	player_HmA
player_Ritchie-Kotschau_RdA	player_Ritchie-Kotschau	player_RdA
player_Ritchie-Kotschau_A.90min	player_Ritchie-Kotschau	player_A.90min
player_John-Carroll_Club	player_John-Carroll	player_Club
player_John-Carroll_POS	player_John-Carroll	player_POS
player_John-Carroll_GP	player_John-Carroll	player_GP
player_John-Carroll_GS	player_John-Carroll	player_GS
player_John-Carroll_A	player_John-Carroll	player_A
player_John-Carroll_GWA	player_John-Carroll	player_GWA
player_John-Carroll_HmA	player_John-Carroll	player_HmA
player_John-Carroll_RdA	player_John-Carroll	player_RdA
player_John-Carroll_A.90min	player_John-Carroll	player_A.90min
player_Geoff-Aunger_Club	player_Geoff-Aunger	player_Club
player_Geoff-Aunger_POS	player_Geoff-Aunger	player_POS
player_Geoff-Aunger_GP	player_Geoff-Aunger	player_GP
player_Geoff-Aunger_GS	player_Geoff-Aunger	player_GS
player_Geoff-Aunger_A	player_Geoff-Aunger	player_A
player_Geoff-Aunger_GWA	player_Geoff-Aunger	player_GWA
player_Geoff-Aunger_HmA	player_Geoff-Aunger	player_HmA
player_Geoff-Aunger_RdA	player_Geoff-Aunger	player_RdA
player_Geoff-Aunger_A.90min	player_Geoff-Aunger	player_A.90min
player_Eddie-Robinson_Club	player_Eddie-Robinson	player_Club
player_Eddie-Robinson_POS	player_Eddie-Robinson	player_POS
player_Eddie-Robinson_GP	player_Eddie-Robinson	player_GP
player_Eddie-Robinson_GS	player_Eddie-Robinson	player_GS
player_Eddie-Robinson_A	player_Eddie-Robinson	player_A
player_Eddie-Robinson_GWA	player_Eddie-Robinson	player_GWA
player_Eddie-Robinson_HmA	player_Eddie-Robinson	player_HmA
player_Eddie-Robinson_RdA	player_Eddie-Robinson	player_RdA
player_Eddie-Robinson_A.90min	player_Eddie-Robinson	player_A.90min
player_Danny-Pena_Club	player_Danny-Pena	player_Club
player_Danny-Pena_POS	player_Danny-Pena	player_POS
player_Danny-Pena_GP	player_Danny-Pena	player_GP
player_Danny-Pena_GS	player_Danny-Pena	player_GS
player_Danny-Pena_A	player_Danny-Pena	player_A
player_Danny-Pena_GWA	player_Danny-Pena	player_GWA
player_Danny-Pena_HmA	player_Danny-Pena	player_HmA
player_Danny-Pena_RdA	player_Danny-Pena	player_RdA
player_Danny-Pena_A.90min	player_Danny-Pena	player_A.90min
player_Stephen-Herdsman_Club	player_Stephen-Herdsman	player_Club
player_Stephen-Herdsman_POS	player_Stephen-Herdsman	player_POS
player_Stephen-Herdsman_GP	player_Stephen-Herdsman	player_GP
player_Stephen-Herdsman_GS	player_Stephen-Herdsman	player_GS
player_Stephen-Herdsman_A	player_Stephen-Herdsman	player_A
player_Stephen-Herdsman_GWA	player_Stephen-Herdsman	player_GWA
player_Stephen-Herdsman_HmA	player_Stephen-Herdsman	player_HmA
player_Stephen-Herdsman_RdA	player_Stephen-Herdsman	player_RdA
player_Stephen-Herdsman_A.90min	player_Stephen-Herdsman	player_A.90min
player_Chris-Dawes_Club	player_Chris-Dawes	player_Club
player_Chris-Dawes_POS	player_Chris-Dawes	player_POS
player_Chris-Dawes_GP	player_Chris-Dawes	player_GP
player_Chris-Dawes_GS	player_Chris-Dawes	player_GS
player_Chris-Dawes_A	player_Chris-Dawes	player_A
player_Chris-Dawes_GWA	player_Chris-Dawes	player_GWA
player_Chris-Dawes_HmA	player_Chris-Dawes	player_HmA
player_Chris-Dawes_RdA	player_Chris-Dawes	player_RdA
player_Chris-Dawes_A.90min	player_Chris-Dawes	player_A.90min
player_Chris-Albright_Club	player_Chris-Albright	player_Club
player_Chris-Albright_POS	player_Chris-Albright	player_POS
player_Chris-Albright_GP	player_Chris-Albright	player_GP
player_Chris-Albright_GS	player_Chris-Albright	player_GS
player_Chris-Albright_A	player_Chris-Albright	player_A
player_Chris-Albright_GWA	player_Chris-Albright	player_GWA
player_Chris-Albright_HmA	player_Chris-Albright	player_HmA
player_Chris-Albright_RdA	player_Chris-Albright	player_RdA
player_Chris-Albright_A.90min	player_Chris-Albright	player_A.90min
player_Rick-Titus_Club	player_Rick-Titus	player_Club
player_Rick-Titus_POS	player_Rick-Titus	player_POS
player_Rick-Titus_GP	player_Rick-Titus	player_GP
player_Rick-Titus_GS	player_Rick-Titus	player_GS
player_Rick-Titus_A	player_Rick-Titus	player_A
player_Rick-Titus_GWA	player_Rick-Titus	player_GWA
player_Rick-Titus_HmA	player_Rick-Titus	player_HmA
player_Rick-Titus_RdA	player_Rick-Titus	player_RdA
player_Rick-Titus_A.90min	player_Rick-Titus	player_A.90min
player_Danny-Jackson_Club	player_Danny-Jackson	player_Club
player_Danny-Jackson_POS	player_Danny-Jackson	player_POS
player_Danny-Jackson_GP	player_Danny-Jackson	player_GP
player_Danny-Jackson_GS	player_Danny-Jackson	player_GS
player_Danny-Jackson_A	player_Danny-Jackson	player_A
player_Danny-Jackson_GWA	player_Danny-Jackson	player_GWA
player_Danny-Jackson_HmA	player_Danny-Jackson	player_HmA
player_Danny-Jackson_RdA	player_Danny-Jackson	player_RdA
player_Danny-Jackson_A.90min	player_Danny-Jackson	player_A.90min
player_Jeff-Agoos_Club	player_Jeff-Agoos	player_Club
player_Jeff-Agoos_POS	player_Jeff-Agoos	player_POS
player_Jeff-Agoos_GP	player_Jeff-Agoos	player_GP
player_Jeff-Agoos_GS	player_Jeff-Agoos	player_GS
player_Jeff-Agoos_A	player_Jeff-Agoos	player_A
player_Jeff-Agoos_GWA	player_Jeff-Agoos	player_GWA
player_Jeff-Agoos_HmA	player_Jeff-Agoos	player_HmA
player_Jeff-Agoos_RdA	player_Jeff-Agoos	player_RdA
player_Jeff-Agoos_A.90min	player_Jeff-Agoos	player_A.90min
player_Alexi-Lalas_Club	player_Alexi-Lalas	player_Club
player_Alexi-Lalas_POS	player_Alexi-Lalas	player_POS
player_Alexi-Lalas_GP	player_Alexi-Lalas	player_GP
player_Alexi-Lalas_GS	player_Alexi-Lalas	player_GS
player_Alexi-Lalas_A	player_Alexi-Lalas	player_A
player_Alexi-Lalas_GWA	player_Alexi-Lalas	player_GWA
player_Alexi-Lalas_HmA	player_Alexi-Lalas	player_HmA
player_Alexi-Lalas_RdA	player_Alexi-Lalas	player_RdA
player_Alexi-Lalas_A.90min	player_Alexi-Lalas	player_A.90min
player_Michael-Piserchio_Club	player_Michael-Piserchio	player_Club
player_Michael-Piserchio_POS	player_Michael-Piserchio	player_POS
player_Michael-Piserchio_GP	player_Michael-Piserchio	player_GP
player_Michael-Piserchio_GS	player_Michael-Piserchio	player_GS
player_Michael-Piserchio_A	player_Michael-Piserchio	player_A
player_Michael-Piserchio_GWA	player_Michael-Piserchio	player_GWA
player_Michael-Piserchio_HmA	player_Michael-Piserchio	player_HmA
player_Michael-Piserchio_RdA	player_Michael-Piserchio	player_RdA
player_Michael-Piserchio_A.90min	player_Michael-Piserchio	player_A.90min
player_Scot-Thompson_Club	player_Scot-Thompson	player_Club
player_Scot-Thompson_POS	player_Scot-Thompson	player_POS
player_Scot-Thompson_GP	player_Scot-Thompson	player_GP
player_Scot-Thompson_GS	player_Scot-Thompson	player_GS
player_Scot-Thompson_A	player_Scot-Thompson	player_A
player_Scot-Thompson_GWA	player_Scot-Thompson	player_GWA
player_Scot-Thompson_HmA	player_Scot-Thompson	player_HmA
player_Scot-Thompson_RdA	player_Scot-Thompson	player_RdA
player_Scot-Thompson_A.90min	player_Scot-Thompson	player_A.90min
player_Billy-Sleeth_Club	player_Billy-Sleeth	player_Club
player_Billy-Sleeth_POS	player_Billy-Sleeth	player_POS
player_Billy-Sleeth_GP	player_Billy-Sleeth	player_GP
player_Billy-Sleeth_GS	player_Billy-Sleeth	player_GS
player_Billy-Sleeth_A	player_Billy-Sleeth	player_A
player_Billy-Sleeth_GWA	player_Billy-Sleeth	player_GWA
player_Billy-Sleeth_HmA	player_Billy-Sleeth	player_HmA
player_Billy-Sleeth_RdA	player_Billy-Sleeth	player_RdA
player_Billy-Sleeth_A.90min	player_Billy-Sleeth	player_A.90min
player_Gilles-Grimandi_Club	player_Gilles-Grimandi	player_Club
player_Gilles-Grimandi_POS	player_Gilles-Grimandi	player_POS
player_Gilles-Grimandi_GP	player_Gilles-Grimandi	player_GP
player_Gilles-Grimandi_GS	player_Gilles-Grimandi	player_GS
player_Gilles-Grimandi_A	player_Gilles-Grimandi	player_A
player_Gilles-Grimandi_GWA	player_Gilles-Grimandi	player_GWA
player_Gilles-Grimandi_HmA	player_Gilles-Grimandi	player_HmA
player_Gilles-Grimandi_RdA	player_Gilles-Grimandi	player_RdA
player_Gilles-Grimandi_A.90min	player_Gilles-Grimandi	player_A.90min
player_Alberto-Rizo_Club	player_Alberto-Rizo	player_Club
player_Alberto-Rizo_POS	player_Alberto-Rizo	player_POS
player_Alberto-Rizo_GP	player_Alberto-Rizo	player_GP
player_Alberto-Rizo_GS	player_Alberto-Rizo	player_GS
player_Alberto-Rizo_A	player_Alberto-Rizo	player_A
player_Alberto-Rizo_GWA	player_Alberto-Rizo	player_GWA
player_Alberto-Rizo_HmA	player_Alberto-Rizo	player_HmA
player_Alberto-Rizo_RdA	player_Alberto-Rizo	player_RdA
player_Alberto-Rizo_A.90min	player_Alberto-Rizo	player_A.90min
player_Jeff-Stewart_Club	player_Jeff-Stewart	player_Club
player_Jeff-Stewart_POS	player_Jeff-Stewart	player_POS
player_Jeff-Stewart_GP	player_Jeff-Stewart	player_GP
player_Jeff-Stewart_GS	player_Jeff-Stewart	player_GS
player_Jeff-Stewart_A	player_Jeff-Stewart	player_A
player_Jeff-Stewart_GWA	player_Jeff-Stewart	player_GWA
player_Jeff-Stewart_HmA	player_Jeff-Stewart	player_HmA
player_Jeff-Stewart_RdA	player_Jeff-Stewart	player_RdA
player_Jeff-Stewart_A.90min	player_Jeff-Stewart	player_A.90min
player_Ricky-Lewis_Club	player_Ricky-Lewis	player_Club
player_Ricky-Lewis_POS	player_Ricky-Lewis	player_POS
player_Ricky-Lewis_GP	player_Ricky-Lewis	player_GP
player_Ricky-Lewis_GS	player_Ricky-Lewis	player_GS
player_Ricky-Lewis_A	player_Ricky-Lewis	player_A
player_Ricky-Lewis_GWA	player_Ricky-Lewis	player_GWA
player_Ricky-Lewis_HmA	player_Ricky-Lewis	player_HmA
player_Ricky-Lewis_RdA	player_Ricky-Lewis	player_RdA
player_Ricky-Lewis_A.90min	player_Ricky-Lewis	player_A.90min
player_Nat-Borchers_Club	player_Nat-Borchers	player_Club
player_Nat-Borchers_POS	player_Nat-Borchers	player_POS
player_Nat-Borchers_GP	player_Nat-Borchers	player_GP
player_Nat-Borchers_GS	player_Nat-Borchers	player_GS
player_Nat-Borchers_A	player_Nat-Borchers	player_A
player_Nat-Borchers_GWA	player_Nat-Borchers	player_GWA
player_Nat-Borchers_HmA	player_Nat-Borchers	player_HmA
player_Nat-Borchers_RdA	player_Nat-Borchers	player_RdA
player_Nat-Borchers_A.90min	player_Nat-Borchers	player_A.90min
player_Ian-Russell_Club	player_Ian-Russell	player_Club
player_Ian-Russell_POS	player_Ian-Russell	player_POS
player_Ian-Russell_GP	player_Ian-Russell	player_GP
player_Ian-Russell_GS	player_Ian-Russell	player_GS
player_Ian-Russell_A	player_Ian-Russell	player_A
player_Ian-Russell_GWA	player_Ian-Russell	player_GWA
player_Ian-Russell_HmA	player_Ian-Russell	player_HmA
player_Ian-Russell_RdA	player_Ian-Russell	player_RdA
player_Ian-Russell_A.90min	player_Ian-Russell	player_A.90min
player_Ryan-Cochrane_Club	player_Ryan-Cochrane	player_Club
player_Ryan-Cochrane_POS	player_Ryan-Cochrane	player_POS
player_Ryan-Cochrane_GP	player_Ryan-Cochrane	player_GP
player_Ryan-Cochrane_GS	player_Ryan-Cochrane	player_GS
player_Ryan-Cochrane_A	player_Ryan-Cochrane	player_A
player_Ryan-Cochrane_GWA	player_Ryan-Cochrane	player_GWA
player_Ryan-Cochrane_HmA	player_Ryan-Cochrane	player_HmA
player_Ryan-Cochrane_RdA	player_Ryan-Cochrane	player_RdA
player_Ryan-Cochrane_A.90min	player_Ryan-Cochrane	player_A.90min
player_Chad-Marshall_Club	player_Chad-Marshall	player_Club
player_Chad-Marshall_POS	player_Chad-Marshall	player_POS
player_Chad-Marshall_GP	player_Chad-Marshall	player_GP
player_Chad-Marshall_GS	player_Chad-Marshall	player_GS
player_Chad-Marshall_A	player_Chad-Marshall	player_A
player_Chad-Marshall_GWA	player_Chad-Marshall	player_GWA
player_Chad-Marshall_HmA	player_Chad-Marshall	player_HmA
player_Chad-Marshall_RdA	player_Chad-Marshall	player_RdA
player_Chad-Marshall_A.90min	player_Chad-Marshall	player_A.90min
player_David-de-la-Torre_Club	player_David-de-la-Torre	player_Club
player_David-de-la-Torre_POS	player_David-de-la-Torre	player_POS
player_David-de-la-Torre_GP	player_David-de-la-Torre	player_GP
player_David-de-la-Torre_GS	player_David-de-la-Torre	player_GS
player_David-de-la-Torre_A	player_David-de-la-Torre	player_A
player_David-de-la-Torre_GWA	player_David-de-la-Torre	player_GWA
player_David-de-la-Torre_HmA	player_David-de-la-Torre	player_HmA
player_David-de-la-Torre_RdA	player_David-de-la-Torre	player_RdA
player_David-de-la-Torre_A.90min	player_David-de-la-Torre	player_A.90min
player_Adrian-Cann_Club	player_Adrian-Cann	player_Club
player_Adrian-Cann_POS	player_Adrian-Cann	player_POS
player_Adrian-Cann_GP	player_Adrian-Cann	player_GP
player_Adrian-Cann_GS	player_Adrian-Cann	player_GS
player_Adrian-Cann_A	player_Adrian-Cann	player_A
player_Adrian-Cann_GWA	player_Adrian-Cann	player_GWA
player_Adrian-Cann_HmA	player_Adrian-Cann	player_HmA
player_Adrian-Cann_RdA	player_Adrian-Cann	player_RdA
player_Adrian-Cann_A.90min	player_Adrian-Cann	player_A.90min
player_Chris-Aloisi_Club	player_Chris-Aloisi	player_Club
player_Chris-Aloisi_POS	player_Chris-Aloisi	player_POS
player_Chris-Aloisi_GP	player_Chris-Aloisi	player_GP
player_Chris-Aloisi_GS	player_Chris-Aloisi	player_GS
player_Chris-Aloisi_A	player_Chris-Aloisi	player_A
player_Chris-Aloisi_GWA	player_Chris-Aloisi	player_GWA
player_Chris-Aloisi_HmA	player_Chris-Aloisi	player_HmA
player_Chris-Aloisi_RdA	player_Chris-Aloisi	player_RdA
player_Chris-Aloisi_A.90min	player_Chris-Aloisi	player_A.90min
player_Gary-Sullivan_Club	player_Gary-Sullivan	player_Club
player_Gary-Sullivan_POS	player_Gary-Sullivan	player_POS
player_Gary-Sullivan_GP	player_Gary-Sullivan	player_GP
player_Gary-Sullivan_GS	player_Gary-Sullivan	player_GS
player_Gary-Sullivan_A	player_Gary-Sullivan	player_A
player_Gary-Sullivan_GWA	player_Gary-Sullivan	player_GWA
player_Gary-Sullivan_HmA	player_Gary-Sullivan	player_HmA
player_Gary-Sullivan_RdA	player_Gary-Sullivan	player_RdA
player_Gary-Sullivan_A.90min	player_Gary-Sullivan	player_A.90min
player_Hong-Myung-Bo_Club	player_Hong-Myung-Bo	player_Club
player_Hong-Myung-Bo_POS	player_Hong-Myung-Bo	player_POS
player_Hong-Myung-Bo_GP	player_Hong-Myung-Bo	player_GP
player_Hong-Myung-Bo_GS	player_Hong-Myung-Bo	player_GS
player_Hong-Myung-Bo_A	player_Hong-Myung-Bo	player_A
player_Hong-Myung-Bo_GWA	player_Hong-Myung-Bo	player_GWA
player_Hong-Myung-Bo_HmA	player_Hong-Myung-Bo	player_HmA
player_Hong-Myung-Bo_RdA	player_Hong-Myung-Bo	player_RdA
player_Hong-Myung-Bo_A.90min	player_Hong-Myung-Bo	player_A.90min
player_Todd-Dunivant_Club	player_Todd-Dunivant	player_Club
player_Todd-Dunivant_POS	player_Todd-Dunivant	player_POS
player_Todd-Dunivant_GP	player_Todd-Dunivant	player_GP
player_Todd-Dunivant_GS	player_Todd-Dunivant	player_GS
player_Todd-Dunivant_A	player_Todd-Dunivant	player_A
player_Todd-Dunivant_GWA	player_Todd-Dunivant	player_GWA
player_Todd-Dunivant_HmA	player_Todd-Dunivant	player_HmA
player_Todd-Dunivant_RdA	player_Todd-Dunivant	player_RdA
player_Todd-Dunivant_A.90min	player_Todd-Dunivant	player_A.90min
player_Ryan-Suarez_Club	player_Ryan-Suarez	player_Club
player_Ryan-Suarez_POS	player_Ryan-Suarez	player_POS
player_Ryan-Suarez_GP	player_Ryan-Suarez	player_GP
player_Ryan-Suarez_GS	player_Ryan-Suarez	player_GS
player_Ryan-Suarez_A	player_Ryan-Suarez	player_A
player_Ryan-Suarez_GWA	player_Ryan-Suarez	player_GWA
player_Ryan-Suarez_HmA	player_Ryan-Suarez	player_HmA
player_Ryan-Suarez_RdA	player_Ryan-Suarez	player_RdA
player_Ryan-Suarez_A.90min	player_Ryan-Suarez	player_A.90min
player_Kevin-Goldthwaite_Club	player_Kevin-Goldthwaite	player_Club
player_Kevin-Goldthwaite_POS	player_Kevin-Goldthwaite	player_POS
player_Kevin-Goldthwaite_GP	player_Kevin-Goldthwaite	player_GP
player_Kevin-Goldthwaite_GS	player_Kevin-Goldthwaite	player_GS
player_Kevin-Goldthwaite_A	player_Kevin-Goldthwaite	player_A
player_Kevin-Goldthwaite_GWA	player_Kevin-Goldthwaite	player_GWA
player_Kevin-Goldthwaite_HmA	player_Kevin-Goldthwaite	player_HmA
player_Kevin-Goldthwaite_RdA	player_Kevin-Goldthwaite	player_RdA
player_Kevin-Goldthwaite_A.90min	player_Kevin-Goldthwaite	player_A.90min
player_Gustavo-Cabrera_Club	player_Gustavo-Cabrera	player_Club
player_Gustavo-Cabrera_POS	player_Gustavo-Cabrera	player_POS
player_Gustavo-Cabrera_GP	player_Gustavo-Cabrera	player_GP
player_Gustavo-Cabrera_GS	player_Gustavo-Cabrera	player_GS
player_Gustavo-Cabrera_A	player_Gustavo-Cabrera	player_A
player_Gustavo-Cabrera_GWA	player_Gustavo-Cabrera	player_GWA
player_Gustavo-Cabrera_HmA	player_Gustavo-Cabrera	player_HmA
player_Gustavo-Cabrera_RdA	player_Gustavo-Cabrera	player_RdA
player_Gustavo-Cabrera_A.90min	player_Gustavo-Cabrera	player_A.90min
player_Guy-Melamed_Club	player_Guy-Melamed	player_Club
player_Guy-Melamed_POS	player_Guy-Melamed	player_POS
player_Guy-Melamed_GP	player_Guy-Melamed	player_GP
player_Guy-Melamed_GS	player_Guy-Melamed	player_GS
player_Guy-Melamed_A	player_Guy-Melamed	player_A
player_Guy-Melamed_GWA	player_Guy-Melamed	player_GWA
player_Guy-Melamed_HmA	player_Guy-Melamed	player_HmA
player_Guy-Melamed_RdA	player_Guy-Melamed	player_RdA
player_Guy-Melamed_A.90min	player_Guy-Melamed	player_A.90min
player_Rusty-Pierce_Club	player_Rusty-Pierce	player_Club
player_Rusty-Pierce_POS	player_Rusty-Pierce	player_POS
player_Rusty-Pierce_GP	player_Rusty-Pierce	player_GP
player_Rusty-Pierce_GS	player_Rusty-Pierce	player_GS
player_Rusty-Pierce_A	player_Rusty-Pierce	player_A
player_Rusty-Pierce_GWA	player_Rusty-Pierce	player_GWA
player_Rusty-Pierce_HmA	player_Rusty-Pierce	player_HmA
player_Rusty-Pierce_RdA	player_Rusty-Pierce	player_RdA
player_Rusty-Pierce_A.90min	player_Rusty-Pierce	player_A.90min
player_Hunter-Freeman_Club	player_Hunter-Freeman	player_Club
player_Hunter-Freeman_POS	player_Hunter-Freeman	player_POS
player_Hunter-Freeman_GP	player_Hunter-Freeman	player_GP
player_Hunter-Freeman_GS	player_Hunter-Freeman	player_GS
player_Hunter-Freeman_A	player_Hunter-Freeman	player_A
player_Hunter-Freeman_GWA	player_Hunter-Freeman	player_GWA
player_Hunter-Freeman_HmA	player_Hunter-Freeman	player_HmA
player_Hunter-Freeman_RdA	player_Hunter-Freeman	player_RdA
player_Hunter-Freeman_A.90min	player_Hunter-Freeman	player_A.90min
player_Ugo-Ihemelu_Club	player_Ugo-Ihemelu	player_Club
player_Ugo-Ihemelu_POS	player_Ugo-Ihemelu	player_POS
player_Ugo-Ihemelu_GP	player_Ugo-Ihemelu	player_GP
player_Ugo-Ihemelu_GS	player_Ugo-Ihemelu	player_GS
player_Ugo-Ihemelu_A	player_Ugo-Ihemelu	player_A
player_Ugo-Ihemelu_GWA	player_Ugo-Ihemelu	player_GWA
player_Ugo-Ihemelu_HmA	player_Ugo-Ihemelu	player_HmA
player_Ugo-Ihemelu_RdA	player_Ugo-Ihemelu	player_RdA
player_Ugo-Ihemelu_A.90min	player_Ugo-Ihemelu	player_A.90min
player_Hector-Castro_Club	player_Hector-Castro	player_Club
player_Hector-Castro_POS	player_Hector-Castro	player_POS
player_Hector-Castro_GP	player_Hector-Castro	player_GP
player_Hector-Castro_GS	player_Hector-Castro	player_GS
player_Hector-Castro_A	player_Hector-Castro	player_A
player_Hector-Castro_GWA	player_Hector-Castro	player_GWA
player_Hector-Castro_HmA	player_Hector-Castro	player_HmA
player_Hector-Castro_RdA	player_Hector-Castro	player_RdA
player_Hector-Castro_A.90min	player_Hector-Castro	player_A.90min
player_Victor-Arbelaez_Club	player_Victor-Arbelaez	player_Club
player_Victor-Arbelaez_POS	player_Victor-Arbelaez	player_POS
player_Victor-Arbelaez_GP	player_Victor-Arbelaez	player_GP
player_Victor-Arbelaez_GS	player_Victor-Arbelaez	player_GS
player_Victor-Arbelaez_A	player_Victor-Arbelaez	player_A
player_Victor-Arbelaez_GWA	player_Victor-Arbelaez	player_GWA
player_Victor-Arbelaez_HmA	player_Victor-Arbelaez	player_HmA
player_Victor-Arbelaez_RdA	player_Victor-Arbelaez	player_RdA
player_Victor-Arbelaez_A.90min	player_Victor-Arbelaez	player_A.90min
player_Sergio-Flores_Club	player_Sergio-Flores	player_Club
player_Sergio-Flores_POS	player_Sergio-Flores	player_POS
player_Sergio-Flores_GP	player_Sergio-Flores	player_GP
player_Sergio-Flores_GS	player_Sergio-Flores	player_GS
player_Sergio-Flores_A	player_Sergio-Flores	player_A
player_Sergio-Flores_GWA	player_Sergio-Flores	player_GWA
player_Sergio-Flores_HmA	player_Sergio-Flores	player_HmA
player_Sergio-Flores_RdA	player_Sergio-Flores	player_RdA
player_Sergio-Flores_A.90min	player_Sergio-Flores	player_A.90min
player_Stephen-Keel_Club	player_Stephen-Keel	player_Club
player_Stephen-Keel_POS	player_Stephen-Keel	player_POS
player_Stephen-Keel_GP	player_Stephen-Keel	player_GP
player_Stephen-Keel_GS	player_Stephen-Keel	player_GS
player_Stephen-Keel_A	player_Stephen-Keel	player_A
player_Stephen-Keel_GWA	player_Stephen-Keel	player_GWA
player_Stephen-Keel_HmA	player_Stephen-Keel	player_HmA
player_Stephen-Keel_RdA	player_Stephen-Keel	player_RdA
player_Stephen-Keel_A.90min	player_Stephen-Keel	player_A.90min
player_Brett-Rodriguez_Club	player_Brett-Rodriguez	player_Club
player_Brett-Rodriguez_POS	player_Brett-Rodriguez	player_POS
player_Brett-Rodriguez_GP	player_Brett-Rodriguez	player_GP
player_Brett-Rodriguez_GS	player_Brett-Rodriguez	player_GS
player_Brett-Rodriguez_A	player_Brett-Rodriguez	player_A
player_Brett-Rodriguez_GWA	player_Brett-Rodriguez	player_GWA
player_Brett-Rodriguez_HmA	player_Brett-Rodriguez	player_HmA
player_Brett-Rodriguez_RdA	player_Brett-Rodriguez	player_RdA
player_Brett-Rodriguez_A.90min	player_Brett-Rodriguez	player_A.90min
player_Michael-Nsien_Club	player_Michael-Nsien	player_Club
player_Michael-Nsien_POS	player_Michael-Nsien	player_POS
player_Michael-Nsien_GP	player_Michael-Nsien	player_GP
player_Michael-Nsien_GS	player_Michael-Nsien	player_GS
player_Michael-Nsien_A	player_Michael-Nsien	player_A
player_Michael-Nsien_GWA	player_Michael-Nsien	player_GWA
player_Michael-Nsien_HmA	player_Michael-Nsien	player_HmA
player_Michael-Nsien_RdA	player_Michael-Nsien	player_RdA
player_Michael-Nsien_A.90min	player_Michael-Nsien	player_A.90min
player_James-Twellman_Club	player_James-Twellman	player_Club
player_James-Twellman_POS	player_James-Twellman	player_POS
player_James-Twellman_GP	player_James-Twellman	player_GP
player_James-Twellman_GS	player_James-Twellman	player_GS
player_James-Twellman_A	player_James-Twellman	player_A
player_James-Twellman_GWA	player_James-Twellman	player_GWA
player_James-Twellman_HmA	player_James-Twellman	player_HmA
player_James-Twellman_RdA	player_James-Twellman	player_RdA
player_James-Twellman_A.90min	player_James-Twellman	player_A.90min
player_Benjamin-Benditson_Club	player_Benjamin-Benditson	player_Club
player_Benjamin-Benditson_POS	player_Benjamin-Benditson	player_POS
player_Benjamin-Benditson_GP	player_Benjamin-Benditson	player_GP
player_Benjamin-Benditson_GS	player_Benjamin-Benditson	player_GS
player_Benjamin-Benditson_A	player_Benjamin-Benditson	player_A
player_Benjamin-Benditson_GWA	player_Benjamin-Benditson	player_GWA
player_Benjamin-Benditson_HmA	player_Benjamin-Benditson	player_HmA
player_Benjamin-Benditson_RdA	player_Benjamin-Benditson	player_RdA
player_Benjamin-Benditson_A.90min	player_Benjamin-Benditson	player_A.90min
player_Danilo-Silva_Club	player_Danilo-Silva	player_Club
player_Danilo-Silva_POS	player_Danilo-Silva	player_POS
player_Danilo-Silva_GP	player_Danilo-Silva	player_GP
player_Danilo-Silva_GS	player_Danilo-Silva	player_GS
player_Danilo-Silva_A	player_Danilo-Silva	player_A
player_Danilo-Silva_GWA	player_Danilo-Silva	player_GWA
player_Danilo-Silva_HmA	player_Danilo-Silva	player_HmA
player_Danilo-Silva_RdA	player_Danilo-Silva	player_RdA
player_Danilo-Silva_A.90min	player_Danilo-Silva	player_A.90min
player_Michael-Lookingland_Club	player_Michael-Lookingland	player_Club
player_Michael-Lookingland_POS	player_Michael-Lookingland	player_POS
player_Michael-Lookingland_GP	player_Michael-Lookingland	player_GP
player_Michael-Lookingland_GS	player_Michael-Lookingland	player_GS
player_Michael-Lookingland_A	player_Michael-Lookingland	player_A
player_Michael-Lookingland_GWA	player_Michael-Lookingland	player_GWA
player_Michael-Lookingland_HmA	player_Michael-Lookingland	player_HmA
player_Michael-Lookingland_RdA	player_Michael-Lookingland	player_RdA
player_Michael-Lookingland_A.90min	player_Michael-Lookingland	player_A.90min
player_Evan-Whitfield_Club	player_Evan-Whitfield	player_Club
player_Evan-Whitfield_POS	player_Evan-Whitfield	player_POS
player_Evan-Whitfield_GP	player_Evan-Whitfield	player_GP
player_Evan-Whitfield_GS	player_Evan-Whitfield	player_GS
player_Evan-Whitfield_A	player_Evan-Whitfield	player_A
player_Evan-Whitfield_GWA	player_Evan-Whitfield	player_GWA
player_Evan-Whitfield_HmA	player_Evan-Whitfield	player_HmA
player_Evan-Whitfield_RdA	player_Evan-Whitfield	player_RdA
player_Evan-Whitfield_A.90min	player_Evan-Whitfield	player_A.90min
player_Kevin-Novak_Club	player_Kevin-Novak	player_Club
player_Kevin-Novak_POS	player_Kevin-Novak	player_POS
player_Kevin-Novak_GP	player_Kevin-Novak	player_GP
player_Kevin-Novak_GS	player_Kevin-Novak	player_GS
player_Kevin-Novak_A	player_Kevin-Novak	player_A
player_Kevin-Novak_GWA	player_Kevin-Novak	player_GWA
player_Kevin-Novak_HmA	player_Kevin-Novak	player_HmA
player_Kevin-Novak_RdA	player_Kevin-Novak	player_RdA
player_Kevin-Novak_A.90min	player_Kevin-Novak	player_A.90min
player_Aaron-Lopez_Club	player_Aaron-Lopez	player_Club
player_Aaron-Lopez_POS	player_Aaron-Lopez	player_POS
player_Aaron-Lopez_GP	player_Aaron-Lopez	player_GP
player_Aaron-Lopez_GS	player_Aaron-Lopez	player_GS
player_Aaron-Lopez_A	player_Aaron-Lopez	player_A
player_Aaron-Lopez_GWA	player_Aaron-Lopez	player_GWA
player_Aaron-Lopez_HmA	player_Aaron-Lopez	player_HmA
player_Aaron-Lopez_RdA	player_Aaron-Lopez	player_RdA
player_Aaron-Lopez_A.90min	player_Aaron-Lopez	player_A.90min
player_Cameron-Knowles_Club	player_Cameron-Knowles	player_Club
player_Cameron-Knowles_POS	player_Cameron-Knowles	player_POS
player_Cameron-Knowles_GP	player_Cameron-Knowles	player_GP
player_Cameron-Knowles_GS	player_Cameron-Knowles	player_GS
player_Cameron-Knowles_A	player_Cameron-Knowles	player_A
player_Cameron-Knowles_GWA	player_Cameron-Knowles	player_GWA
player_Cameron-Knowles_HmA	player_Cameron-Knowles	player_HmA
player_Cameron-Knowles_RdA	player_Cameron-Knowles	player_RdA
player_Cameron-Knowles_A.90min	player_Cameron-Knowles	player_A.90min
player_Marlon-Rojas_Club	player_Marlon-Rojas	player_Club
player_Marlon-Rojas_POS	player_Marlon-Rojas	player_POS
player_Marlon-Rojas_GP	player_Marlon-Rojas	player_GP
player_Marlon-Rojas_GS	player_Marlon-Rojas	player_GS
player_Marlon-Rojas_A	player_Marlon-Rojas	player_A
player_Marlon-Rojas_GWA	player_Marlon-Rojas	player_GWA
player_Marlon-Rojas_HmA	player_Marlon-Rojas	player_HmA
player_Marlon-Rojas_RdA	player_Marlon-Rojas	player_RdA
player_Marlon-Rojas_A.90min	player_Marlon-Rojas	player_A.90min
player_Matt-Behncke_Club	player_Matt-Behncke	player_Club
player_Matt-Behncke_POS	player_Matt-Behncke	player_POS
player_Matt-Behncke_GP	player_Matt-Behncke	player_GP
player_Matt-Behncke_GS	player_Matt-Behncke	player_GS
player_Matt-Behncke_A	player_Matt-Behncke	player_A
player_Matt-Behncke_GWA	player_Matt-Behncke	player_GWA
player_Matt-Behncke_HmA	player_Matt-Behncke	player_HmA
player_Matt-Behncke_RdA	player_Matt-Behncke	player_RdA
player_Matt-Behncke_A.90min	player_Matt-Behncke	player_A.90min
player_Michael-Uma–a_Club	player_Michael-Uma–a	player_Club
player_Michael-Uma–a_POS	player_Michael-Uma–a	player_POS
player_Michael-Uma–a_GP	player_Michael-Uma–a	player_GP
player_Michael-Uma–a_GS	player_Michael-Uma–a	player_GS
player_Michael-Uma–a_A	player_Michael-Uma–a	player_A
player_Michael-Uma–a_GWA	player_Michael-Uma–a	player_GWA
player_Michael-Uma–a_HmA	player_Michael-Uma–a	player_HmA
player_Michael-Uma–a_RdA	player_Michael-Uma–a	player_RdA
player_Michael-Uma–a_A.90min	player_Michael-Uma–a	player_A.90min
player_Troy-Roberts_Club	player_Troy-Roberts	player_Club
player_Troy-Roberts_POS	player_Troy-Roberts	player_POS
player_Troy-Roberts_GP	player_Troy-Roberts	player_GP
player_Troy-Roberts_GS	player_Troy-Roberts	player_GS
player_Troy-Roberts_A	player_Troy-Roberts	player_A
player_Troy-Roberts_GWA	player_Troy-Roberts	player_GWA
player_Troy-Roberts_HmA	player_Troy-Roberts	player_HmA
player_Troy-Roberts_RdA	player_Troy-Roberts	player_RdA
player_Troy-Roberts_A.90min	player_Troy-Roberts	player_A.90min
player_Alfonso-Loera_Club	player_Alfonso-Loera	player_Club
player_Alfonso-Loera_POS	player_Alfonso-Loera	player_POS
player_Alfonso-Loera_GP	player_Alfonso-Loera	player_GP
player_Alfonso-Loera_GS	player_Alfonso-Loera	player_GS
player_Alfonso-Loera_A	player_Alfonso-Loera	player_A
player_Alfonso-Loera_GWA	player_Alfonso-Loera	player_GWA
player_Alfonso-Loera_HmA	player_Alfonso-Loera	player_HmA
player_Alfonso-Loera_RdA	player_Alfonso-Loera	player_RdA
player_Alfonso-Loera_A.90min	player_Alfonso-Loera	player_A.90min
player_Danny-O'Rourke_Club	player_Danny-O'Rourke	player_Club
player_Danny-O'Rourke_POS	player_Danny-O'Rourke	player_POS
player_Danny-O'Rourke_GP	player_Danny-O'Rourke	player_GP
player_Danny-O'Rourke_GS	player_Danny-O'Rourke	player_GS
player_Danny-O'Rourke_A	player_Danny-O'Rourke	player_A
player_Danny-O'Rourke_GWA	player_Danny-O'Rourke	player_GWA
player_Danny-O'Rourke_HmA	player_Danny-O'Rourke	player_HmA
player_Danny-O'Rourke_RdA	player_Danny-O'Rourke	player_RdA
player_Danny-O'Rourke_A.90min	player_Danny-O'Rourke	player_A.90min
player_Esteban-Arias_Club	player_Esteban-Arias	player_Club
player_Esteban-Arias_POS	player_Esteban-Arias	player_POS
player_Esteban-Arias_GP	player_Esteban-Arias	player_GP
player_Esteban-Arias_GS	player_Esteban-Arias	player_GS
player_Esteban-Arias_A	player_Esteban-Arias	player_A
player_Esteban-Arias_GWA	player_Esteban-Arias	player_GWA
player_Esteban-Arias_HmA	player_Esteban-Arias	player_HmA
player_Esteban-Arias_RdA	player_Esteban-Arias	player_RdA
player_Esteban-Arias_A.90min	player_Esteban-Arias	player_A.90min
player_Pablo-Chinchilla_Club	player_Pablo-Chinchilla	player_Club
player_Pablo-Chinchilla_POS	player_Pablo-Chinchilla	player_POS
player_Pablo-Chinchilla_GP	player_Pablo-Chinchilla	player_GP
player_Pablo-Chinchilla_GS	player_Pablo-Chinchilla	player_GS
player_Pablo-Chinchilla_A	player_Pablo-Chinchilla	player_A
player_Pablo-Chinchilla_GWA	player_Pablo-Chinchilla	player_GWA
player_Pablo-Chinchilla_HmA	player_Pablo-Chinchilla	player_HmA
player_Pablo-Chinchilla_RdA	player_Pablo-Chinchilla	player_RdA
player_Pablo-Chinchilla_A.90min	player_Pablo-Chinchilla	player_A.90min
player_Armando-Begines_Club	player_Armando-Begines	player_Club
player_Armando-Begines_POS	player_Armando-Begines	player_POS
player_Armando-Begines_GP	player_Armando-Begines	player_GP
player_Armando-Begines_GS	player_Armando-Begines	player_GS
player_Armando-Begines_A	player_Armando-Begines	player_A
player_Armando-Begines_GWA	player_Armando-Begines	player_GWA
player_Armando-Begines_HmA	player_Armando-Begines	player_HmA
player_Armando-Begines_RdA	player_Armando-Begines	player_RdA
player_Armando-Begines_A.90min	player_Armando-Begines	player_A.90min
player_Eddie-Pope_Club	player_Eddie-Pope	player_Club
player_Eddie-Pope_POS	player_Eddie-Pope	player_POS
player_Eddie-Pope_GP	player_Eddie-Pope	player_GP
player_Eddie-Pope_GS	player_Eddie-Pope	player_GS
player_Eddie-Pope_A	player_Eddie-Pope	player_A
player_Eddie-Pope_GWA	player_Eddie-Pope	player_GWA
player_Eddie-Pope_HmA	player_Eddie-Pope	player_HmA
player_Eddie-Pope_RdA	player_Eddie-Pope	player_RdA
player_Eddie-Pope_A.90min	player_Eddie-Pope	player_A.90min
player_Nelson-Akwari_Club	player_Nelson-Akwari	player_Club
player_Nelson-Akwari_POS	player_Nelson-Akwari	player_POS
player_Nelson-Akwari_GP	player_Nelson-Akwari	player_GP
player_Nelson-Akwari_GS	player_Nelson-Akwari	player_GS
player_Nelson-Akwari_A	player_Nelson-Akwari	player_A
player_Nelson-Akwari_GWA	player_Nelson-Akwari	player_GWA
player_Nelson-Akwari_HmA	player_Nelson-Akwari	player_HmA
player_Nelson-Akwari_RdA	player_Nelson-Akwari	player_RdA
player_Nelson-Akwari_A.90min	player_Nelson-Akwari	player_A.90min
player_Brian-Dunseth_Club	player_Brian-Dunseth	player_Club
player_Brian-Dunseth_POS	player_Brian-Dunseth	player_POS
player_Brian-Dunseth_GP	player_Brian-Dunseth	player_GP
player_Brian-Dunseth_GS	player_Brian-Dunseth	player_GS
player_Brian-Dunseth_A	player_Brian-Dunseth	player_A
player_Brian-Dunseth_GWA	player_Brian-Dunseth	player_GWA
player_Brian-Dunseth_HmA	player_Brian-Dunseth	player_HmA
player_Brian-Dunseth_RdA	player_Brian-Dunseth	player_RdA
player_Brian-Dunseth_A.90min	player_Brian-Dunseth	player_A.90min
player_Mike-Petke_Club	player_Mike-Petke	player_Club
player_Mike-Petke_POS	player_Mike-Petke	player_POS
player_Mike-Petke_GP	player_Mike-Petke	player_GP
player_Mike-Petke_GS	player_Mike-Petke	player_GS
player_Mike-Petke_A	player_Mike-Petke	player_A
player_Mike-Petke_GWA	player_Mike-Petke	player_GWA
player_Mike-Petke_HmA	player_Mike-Petke	player_HmA
player_Mike-Petke_RdA	player_Mike-Petke	player_RdA
player_Mike-Petke_A.90min	player_Mike-Petke	player_A.90min
player_Carlos-Llamosa_Club	player_Carlos-Llamosa	player_Club
player_Carlos-Llamosa_POS	player_Carlos-Llamosa	player_POS
player_Carlos-Llamosa_GP	player_Carlos-Llamosa	player_GP
player_Carlos-Llamosa_GS	player_Carlos-Llamosa	player_GS
player_Carlos-Llamosa_A	player_Carlos-Llamosa	player_A
player_Carlos-Llamosa_GWA	player_Carlos-Llamosa	player_GWA
player_Carlos-Llamosa_HmA	player_Carlos-Llamosa	player_HmA
player_Carlos-Llamosa_RdA	player_Carlos-Llamosa	player_RdA
player_Carlos-Llamosa_A.90min	player_Carlos-Llamosa	player_A.90min
player_Lawson-Vaughn_Club	player_Lawson-Vaughn	player_Club
player_Lawson-Vaughn_POS	player_Lawson-Vaughn	player_POS
player_Lawson-Vaughn_GP	player_Lawson-Vaughn	player_GP
player_Lawson-Vaughn_GS	player_Lawson-Vaughn	player_GS
player_Lawson-Vaughn_A	player_Lawson-Vaughn	player_A
player_Lawson-Vaughn_GWA	player_Lawson-Vaughn	player_GWA
player_Lawson-Vaughn_HmA	player_Lawson-Vaughn	player_HmA
player_Lawson-Vaughn_RdA	player_Lawson-Vaughn	player_RdA
player_Lawson-Vaughn_A.90min	player_Lawson-Vaughn	player_A.90min
player_Atiba-Harris_Club	player_Atiba-Harris	player_Club
player_Atiba-Harris_POS	player_Atiba-Harris	player_POS
player_Atiba-Harris_GP	player_Atiba-Harris	player_GP
player_Atiba-Harris_GS	player_Atiba-Harris	player_GS
player_Atiba-Harris_A	player_Atiba-Harris	player_A
player_Atiba-Harris_GWA	player_Atiba-Harris	player_GWA
player_Atiba-Harris_HmA	player_Atiba-Harris	player_HmA
player_Atiba-Harris_RdA	player_Atiba-Harris	player_RdA
player_Atiba-Harris_A.90min	player_Atiba-Harris	player_A.90min
player_Dan-Gargan_Club	player_Dan-Gargan	player_Club
player_Dan-Gargan_POS	player_Dan-Gargan	player_POS
player_Dan-Gargan_GP	player_Dan-Gargan	player_GP
player_Dan-Gargan_GS	player_Dan-Gargan	player_GS
player_Dan-Gargan_A	player_Dan-Gargan	player_A
player_Dan-Gargan_GWA	player_Dan-Gargan	player_GWA
player_Dan-Gargan_HmA	player_Dan-Gargan	player_HmA
player_Dan-Gargan_RdA	player_Dan-Gargan	player_RdA
player_Dan-Gargan_A.90min	player_Dan-Gargan	player_A.90min
player_Claudio-Suarez_Club	player_Claudio-Suarez	player_Club
player_Claudio-Suarez_POS	player_Claudio-Suarez	player_POS
player_Claudio-Suarez_GP	player_Claudio-Suarez	player_GP
player_Claudio-Suarez_GS	player_Claudio-Suarez	player_GS
player_Claudio-Suarez_A	player_Claudio-Suarez	player_A
player_Claudio-Suarez_GWA	player_Claudio-Suarez	player_GWA
player_Claudio-Suarez_HmA	player_Claudio-Suarez	player_HmA
player_Claudio-Suarez_RdA	player_Claudio-Suarez	player_RdA
player_Claudio-Suarez_A.90min	player_Claudio-Suarez	player_A.90min
player_Willis-Forko_Club	player_Willis-Forko	player_Club
player_Willis-Forko_POS	player_Willis-Forko	player_POS
player_Willis-Forko_GP	player_Willis-Forko	player_GP
player_Willis-Forko_GS	player_Willis-Forko	player_GS
player_Willis-Forko_A	player_Willis-Forko	player_A
player_Willis-Forko_GWA	player_Willis-Forko	player_GWA
player_Willis-Forko_HmA	player_Willis-Forko	player_HmA
player_Willis-Forko_RdA	player_Willis-Forko	player_RdA
player_Willis-Forko_A.90min	player_Willis-Forko	player_A.90min
player_Aitor-Karanka_Club	player_Aitor-Karanka	player_Club
player_Aitor-Karanka_POS	player_Aitor-Karanka	player_POS
player_Aitor-Karanka_GP	player_Aitor-Karanka	player_GP
player_Aitor-Karanka_GS	player_Aitor-Karanka	player_GS
player_Aitor-Karanka_A	player_Aitor-Karanka	player_A
player_Aitor-Karanka_GWA	player_Aitor-Karanka	player_GWA
player_Aitor-Karanka_HmA	player_Aitor-Karanka	player_HmA
player_Aitor-Karanka_RdA	player_Aitor-Karanka	player_RdA
player_Aitor-Karanka_A.90min	player_Aitor-Karanka	player_A.90min
player_Jordan-Harvey_Club	player_Jordan-Harvey	player_Club
player_Jordan-Harvey_POS	player_Jordan-Harvey	player_POS
player_Jordan-Harvey_GP	player_Jordan-Harvey	player_GP
player_Jordan-Harvey_GS	player_Jordan-Harvey	player_GS
player_Jordan-Harvey_A	player_Jordan-Harvey	player_A
player_Jordan-Harvey_GWA	player_Jordan-Harvey	player_GWA
player_Jordan-Harvey_HmA	player_Jordan-Harvey	player_HmA
player_Jordan-Harvey_RdA	player_Jordan-Harvey	player_RdA
player_Jordan-Harvey_A.90min	player_Jordan-Harvey	player_A.90min
player_Mike-Randolph_Club	player_Mike-Randolph	player_Club
player_Mike-Randolph_POS	player_Mike-Randolph	player_POS
player_Mike-Randolph_GP	player_Mike-Randolph	player_GP
player_Mike-Randolph_GS	player_Mike-Randolph	player_GS
player_Mike-Randolph_A	player_Mike-Randolph	player_A
player_Mike-Randolph_GWA	player_Mike-Randolph	player_GWA
player_Mike-Randolph_HmA	player_Mike-Randolph	player_HmA
player_Mike-Randolph_RdA	player_Mike-Randolph	player_RdA
player_Mike-Randolph_A.90min	player_Mike-Randolph	player_A.90min
player_Eder-Robles_Club	player_Eder-Robles	player_Club
player_Eder-Robles_POS	player_Eder-Robles	player_POS
player_Eder-Robles_GP	player_Eder-Robles	player_GP
player_Eder-Robles_GS	player_Eder-Robles	player_GS
player_Eder-Robles_A	player_Eder-Robles	player_A
player_Eder-Robles_GWA	player_Eder-Robles	player_GWA
player_Eder-Robles_HmA	player_Eder-Robles	player_HmA
player_Eder-Robles_RdA	player_Eder-Robles	player_RdA
player_Eder-Robles_A.90min	player_Eder-Robles	player_A.90min
player_Carlos-Borja_Club	player_Carlos-Borja	player_Club
player_Carlos-Borja_POS	player_Carlos-Borja	player_POS
player_Carlos-Borja_GP	player_Carlos-Borja	player_GP
player_Carlos-Borja_GS	player_Carlos-Borja	player_GS
player_Carlos-Borja_A	player_Carlos-Borja	player_A
player_Carlos-Borja_GWA	player_Carlos-Borja	player_GWA
player_Carlos-Borja_HmA	player_Carlos-Borja	player_HmA
player_Carlos-Borja_RdA	player_Carlos-Borja	player_RdA
player_Carlos-Borja_A.90min	player_Carlos-Borja	player_A.90min
player_Johnny-Garcia_Club	player_Johnny-Garcia	player_Club
player_Johnny-Garcia_POS	player_Johnny-Garcia	player_POS
player_Johnny-Garcia_GP	player_Johnny-Garcia	player_GP
player_Johnny-Garcia_GS	player_Johnny-Garcia	player_GS
player_Johnny-Garcia_A	player_Johnny-Garcia	player_A
player_Johnny-Garcia_GWA	player_Johnny-Garcia	player_GWA
player_Johnny-Garcia_HmA	player_Johnny-Garcia	player_HmA
player_Johnny-Garcia_RdA	player_Johnny-Garcia	player_RdA
player_Johnny-Garcia_A.90min	player_Johnny-Garcia	player_A.90min
player_Chris-Wingert_Club	player_Chris-Wingert	player_Club
player_Chris-Wingert_POS	player_Chris-Wingert	player_POS
player_Chris-Wingert_GP	player_Chris-Wingert	player_GP
player_Chris-Wingert_GS	player_Chris-Wingert	player_GS
player_Chris-Wingert_A	player_Chris-Wingert	player_A
player_Chris-Wingert_GWA	player_Chris-Wingert	player_GWA
player_Chris-Wingert_HmA	player_Chris-Wingert	player_HmA
player_Chris-Wingert_RdA	player_Chris-Wingert	player_RdA
player_Chris-Wingert_A.90min	player_Chris-Wingert	player_A.90min
player_Daniel-Wasson_Club	player_Daniel-Wasson	player_Club
player_Daniel-Wasson_POS	player_Daniel-Wasson	player_POS
player_Daniel-Wasson_GP	player_Daniel-Wasson	player_GP
player_Daniel-Wasson_GS	player_Daniel-Wasson	player_GS
player_Daniel-Wasson_A	player_Daniel-Wasson	player_A
player_Daniel-Wasson_GWA	player_Daniel-Wasson	player_GWA
player_Daniel-Wasson_HmA	player_Daniel-Wasson	player_HmA
player_Daniel-Wasson_RdA	player_Daniel-Wasson	player_RdA
player_Daniel-Wasson_A.90min	player_Daniel-Wasson	player_A.90min
player_Kyle-Veris_Club	player_Kyle-Veris	player_Club
player_Kyle-Veris_POS	player_Kyle-Veris	player_POS
player_Kyle-Veris_GP	player_Kyle-Veris	player_GP
player_Kyle-Veris_GS	player_Kyle-Veris	player_GS
player_Kyle-Veris_A	player_Kyle-Veris	player_A
player_Kyle-Veris_GWA	player_Kyle-Veris	player_GWA
player_Kyle-Veris_HmA	player_Kyle-Veris	player_HmA
player_Kyle-Veris_RdA	player_Kyle-Veris	player_RdA
player_Kyle-Veris_A.90min	player_Kyle-Veris	player_A.90min
player_Ante-Jazic_Club	player_Ante-Jazic	player_Club
player_Ante-Jazic_POS	player_Ante-Jazic	player_POS
player_Ante-Jazic_GP	player_Ante-Jazic	player_GP
player_Ante-Jazic_GS	player_Ante-Jazic	player_GS
player_Ante-Jazic_A	player_Ante-Jazic	player_A
player_Ante-Jazic_GWA	player_Ante-Jazic	player_GWA
player_Ante-Jazic_HmA	player_Ante-Jazic	player_HmA
player_Ante-Jazic_RdA	player_Ante-Jazic	player_RdA
player_Ante-Jazic_A.90min	player_Ante-Jazic	player_A.90min
player_Orlando-Perez_Club	player_Orlando-Perez	player_Club
player_Orlando-Perez_POS	player_Orlando-Perez	player_POS
player_Orlando-Perez_GP	player_Orlando-Perez	player_GP
player_Orlando-Perez_GS	player_Orlando-Perez	player_GS
player_Orlando-Perez_A	player_Orlando-Perez	player_A
player_Orlando-Perez_GWA	player_Orlando-Perez	player_GWA
player_Orlando-Perez_HmA	player_Orlando-Perez	player_HmA
player_Orlando-Perez_RdA	player_Orlando-Perez	player_RdA
player_Orlando-Perez_A.90min	player_Orlando-Perez	player_A.90min
player_Daniel-Torres_Club	player_Daniel-Torres	player_Club
player_Daniel-Torres_POS	player_Daniel-Torres	player_POS
player_Daniel-Torres_GP	player_Daniel-Torres	player_GP
player_Daniel-Torres_GS	player_Daniel-Torres	player_GS
player_Daniel-Torres_A	player_Daniel-Torres	player_A
player_Daniel-Torres_GWA	player_Daniel-Torres	player_GWA
player_Daniel-Torres_HmA	player_Daniel-Torres	player_HmA
player_Daniel-Torres_RdA	player_Daniel-Torres	player_RdA
player_Daniel-Torres_A.90min	player_Daniel-Torres	player_A.90min
player_Jason-Hernandez_Club	player_Jason-Hernandez	player_Club
player_Jason-Hernandez_POS	player_Jason-Hernandez	player_POS
player_Jason-Hernandez_GP	player_Jason-Hernandez	player_GP
player_Jason-Hernandez_GS	player_Jason-Hernandez	player_GS
player_Jason-Hernandez_A	player_Jason-Hernandez	player_A
player_Jason-Hernandez_GWA	player_Jason-Hernandez	player_GWA
player_Jason-Hernandez_HmA	player_Jason-Hernandez	player_HmA
player_Jason-Hernandez_RdA	player_Jason-Hernandez	player_RdA
player_Jason-Hernandez_A.90min	player_Jason-Hernandez	player_A.90min
player_Tim-Regan_Club	player_Tim-Regan	player_Club
player_Tim-Regan_POS	player_Tim-Regan	player_POS
player_Tim-Regan_GP	player_Tim-Regan	player_GP
player_Tim-Regan_GS	player_Tim-Regan	player_GS
player_Tim-Regan_A	player_Tim-Regan	player_A
player_Tim-Regan_GWA	player_Tim-Regan	player_GWA
player_Tim-Regan_HmA	player_Tim-Regan	player_HmA
player_Tim-Regan_RdA	player_Tim-Regan	player_RdA
player_Tim-Regan_A.90min	player_Tim-Regan	player_A.90min
player_Chris-Lancos_Club	player_Chris-Lancos	player_Club
player_Chris-Lancos_POS	player_Chris-Lancos	player_POS
player_Chris-Lancos_GP	player_Chris-Lancos	player_GP
player_Chris-Lancos_GS	player_Chris-Lancos	player_GS
player_Chris-Lancos_A	player_Chris-Lancos	player_A
player_Chris-Lancos_GWA	player_Chris-Lancos	player_GWA
player_Chris-Lancos_HmA	player_Chris-Lancos	player_HmA
player_Chris-Lancos_RdA	player_Chris-Lancos	player_RdA
player_Chris-Lancos_A.90min	player_Chris-Lancos	player_A.90min
player_Abel-Xavier_Club	player_Abel-Xavier	player_Club
player_Abel-Xavier_POS	player_Abel-Xavier	player_POS
player_Abel-Xavier_GP	player_Abel-Xavier	player_GP
player_Abel-Xavier_GS	player_Abel-Xavier	player_GS
player_Abel-Xavier_A	player_Abel-Xavier	player_A
player_Abel-Xavier_GWA	player_Abel-Xavier	player_GWA
player_Abel-Xavier_HmA	player_Abel-Xavier	player_HmA
player_Abel-Xavier_RdA	player_Abel-Xavier	player_RdA
player_Abel-Xavier_A.90min	player_Abel-Xavier	player_A.90min
player_Jack-Stewart_Club	player_Jack-Stewart	player_Club
player_Jack-Stewart_POS	player_Jack-Stewart	player_POS
player_Jack-Stewart_GP	player_Jack-Stewart	player_GP
player_Jack-Stewart_GS	player_Jack-Stewart	player_GS
player_Jack-Stewart_A	player_Jack-Stewart	player_A
player_Jack-Stewart_GWA	player_Jack-Stewart	player_GWA
player_Jack-Stewart_HmA	player_Jack-Stewart	player_HmA
player_Jack-Stewart_RdA	player_Jack-Stewart	player_RdA
player_Jack-Stewart_A.90min	player_Jack-Stewart	player_A.90min
player_Jonathan-Bornstein_Club	player_Jonathan-Bornstein	player_Club
player_Jonathan-Bornstein_POS	player_Jonathan-Bornstein	player_POS
player_Jonathan-Bornstein_GP	player_Jonathan-Bornstein	player_GP
player_Jonathan-Bornstein_GS	player_Jonathan-Bornstein	player_GS
player_Jonathan-Bornstein_A	player_Jonathan-Bornstein	player_A
player_Jonathan-Bornstein_GWA	player_Jonathan-Bornstein	player_GWA
player_Jonathan-Bornstein_HmA	player_Jonathan-Bornstein	player_HmA
player_Jonathan-Bornstein_RdA	player_Jonathan-Bornstein	player_RdA
player_Jonathan-Bornstein_A.90min	player_Jonathan-Bornstein	player_A.90min
player_Carey-Talley_Club	player_Carey-Talley	player_Club
player_Carey-Talley_POS	player_Carey-Talley	player_POS
player_Carey-Talley_GP	player_Carey-Talley	player_GP
player_Carey-Talley_GS	player_Carey-Talley	player_GS
player_Carey-Talley_A	player_Carey-Talley	player_A
player_Carey-Talley_GWA	player_Carey-Talley	player_GWA
player_Carey-Talley_HmA	player_Carey-Talley	player_HmA
player_Carey-Talley_RdA	player_Carey-Talley	player_RdA
player_Carey-Talley_A.90min	player_Carey-Talley	player_A.90min
player_Desmond-Brooks_Club	player_Desmond-Brooks	player_Club
player_Desmond-Brooks_POS	player_Desmond-Brooks	player_POS
player_Desmond-Brooks_GP	player_Desmond-Brooks	player_GP
player_Desmond-Brooks_GS	player_Desmond-Brooks	player_GS
player_Desmond-Brooks_A	player_Desmond-Brooks	player_A
player_Desmond-Brooks_GWA	player_Desmond-Brooks	player_GWA
player_Desmond-Brooks_HmA	player_Desmond-Brooks	player_HmA
player_Desmond-Brooks_RdA	player_Desmond-Brooks	player_RdA
player_Desmond-Brooks_A.90min	player_Desmond-Brooks	player_A.90min
player_Bobby-Burling_Club	player_Bobby-Burling	player_Club
player_Bobby-Burling_POS	player_Bobby-Burling	player_POS
player_Bobby-Burling_GP	player_Bobby-Burling	player_GP
player_Bobby-Burling_GS	player_Bobby-Burling	player_GS
player_Bobby-Burling_A	player_Bobby-Burling	player_A
player_Bobby-Burling_GWA	player_Bobby-Burling	player_GWA
player_Bobby-Burling_HmA	player_Bobby-Burling	player_HmA
player_Bobby-Burling_RdA	player_Bobby-Burling	player_RdA
player_Bobby-Burling_A.90min	player_Bobby-Burling	player_A.90min
player_Jorge-Barrera_Club	player_Jorge-Barrera	player_Club
player_Jorge-Barrera_POS	player_Jorge-Barrera	player_POS
player_Jorge-Barrera_GP	player_Jorge-Barrera	player_GP
player_Jorge-Barrera_GS	player_Jorge-Barrera	player_GS
player_Jorge-Barrera_A	player_Jorge-Barrera	player_A
player_Jorge-Barrera_GWA	player_Jorge-Barrera	player_GWA
player_Jorge-Barrera_HmA	player_Jorge-Barrera	player_HmA
player_Jorge-Barrera_RdA	player_Jorge-Barrera	player_RdA
player_Jorge-Barrera_A.90min	player_Jorge-Barrera	player_A.90min
player_Clifton-Wilmes_Club	player_Clifton-Wilmes	player_Club
player_Clifton-Wilmes_POS	player_Clifton-Wilmes	player_POS
player_Clifton-Wilmes_GP	player_Clifton-Wilmes	player_GP
player_Clifton-Wilmes_GS	player_Clifton-Wilmes	player_GS
player_Clifton-Wilmes_A	player_Clifton-Wilmes	player_A
player_Clifton-Wilmes_GWA	player_Clifton-Wilmes	player_GWA
player_Clifton-Wilmes_HmA	player_Clifton-Wilmes	player_HmA
player_Clifton-Wilmes_RdA	player_Clifton-Wilmes	player_RdA
player_Clifton-Wilmes_A.90min	player_Clifton-Wilmes	player_A.90min
player_Jorge-Villafa–a_Club	player_Jorge-Villafa–a	player_Club
player_Jorge-Villafa–a_POS	player_Jorge-Villafa–a	player_POS
player_Jorge-Villafa–a_GP	player_Jorge-Villafa–a	player_GP
player_Jorge-Villafa–a_GS	player_Jorge-Villafa–a	player_GS
player_Jorge-Villafa–a_A	player_Jorge-Villafa–a	player_A
player_Jorge-Villafa–a_GWA	player_Jorge-Villafa–a	player_GWA
player_Jorge-Villafa–a_HmA	player_Jorge-Villafa–a	player_HmA
player_Jorge-Villafa–a_RdA	player_Jorge-Villafa–a	player_RdA
player_Jorge-Villafa–a_A.90min	player_Jorge-Villafa–a	player_A.90min
player_Dustin-Kirby_Club	player_Dustin-Kirby	player_Club
player_Dustin-Kirby_POS	player_Dustin-Kirby	player_POS
player_Dustin-Kirby_GP	player_Dustin-Kirby	player_GP
player_Dustin-Kirby_GS	player_Dustin-Kirby	player_GS
player_Dustin-Kirby_A	player_Dustin-Kirby	player_A
player_Dustin-Kirby_GWA	player_Dustin-Kirby	player_GWA
player_Dustin-Kirby_HmA	player_Dustin-Kirby	player_HmA
player_Dustin-Kirby_RdA	player_Dustin-Kirby	player_RdA
player_Dustin-Kirby_A.90min	player_Dustin-Kirby	player_A.90min
player_Kosuke-Kimura_Club	player_Kosuke-Kimura	player_Club
player_Kosuke-Kimura_POS	player_Kosuke-Kimura	player_POS
player_Kosuke-Kimura_GP	player_Kosuke-Kimura	player_GP
player_Kosuke-Kimura_GS	player_Kosuke-Kimura	player_GS
player_Kosuke-Kimura_A	player_Kosuke-Kimura	player_A
player_Kosuke-Kimura_GWA	player_Kosuke-Kimura	player_GWA
player_Kosuke-Kimura_HmA	player_Kosuke-Kimura	player_HmA
player_Kosuke-Kimura_RdA	player_Kosuke-Kimura	player_RdA
player_Kosuke-Kimura_A.90min	player_Kosuke-Kimura	player_A.90min
player_Tony-Sanneh_Club	player_Tony-Sanneh	player_Club
player_Tony-Sanneh_POS	player_Tony-Sanneh	player_POS
player_Tony-Sanneh_GP	player_Tony-Sanneh	player_GP
player_Tony-Sanneh_GS	player_Tony-Sanneh	player_GS
player_Tony-Sanneh_A	player_Tony-Sanneh	player_A
player_Tony-Sanneh_GWA	player_Tony-Sanneh	player_GWA
player_Tony-Sanneh_HmA	player_Tony-Sanneh	player_HmA
player_Tony-Sanneh_RdA	player_Tony-Sanneh	player_RdA
player_Tony-Sanneh_A.90min	player_Tony-Sanneh	player_A.90min
player_Matias-Mantilla_Club	player_Matias-Mantilla	player_Club
player_Matias-Mantilla_POS	player_Matias-Mantilla	player_POS
player_Matias-Mantilla_GP	player_Matias-Mantilla	player_GP
player_Matias-Mantilla_GS	player_Matias-Mantilla	player_GS
player_Matias-Mantilla_A	player_Matias-Mantilla	player_A
player_Matias-Mantilla_GWA	player_Matias-Mantilla	player_GWA
player_Matias-Mantilla_HmA	player_Matias-Mantilla	player_HmA
player_Matias-Mantilla_RdA	player_Matias-Mantilla	player_RdA
player_Matias-Mantilla_A.90min	player_Matias-Mantilla	player_A.90min
player_Jean-Martial-Kipre_Club	player_Jean-Martial-Kipre	player_Club
player_Jean-Martial-Kipre_POS	player_Jean-Martial-Kipre	player_POS
player_Jean-Martial-Kipre_GP	player_Jean-Martial-Kipre	player_GP
player_Jean-Martial-Kipre_GS	player_Jean-Martial-Kipre	player_GS
player_Jean-Martial-Kipre_A	player_Jean-Martial-Kipre	player_A
player_Jean-Martial-Kipre_GWA	player_Jean-Martial-Kipre	player_GWA
player_Jean-Martial-Kipre_HmA	player_Jean-Martial-Kipre	player_HmA
player_Jean-Martial-Kipre_RdA	player_Jean-Martial-Kipre	player_RdA
player_Jean-Martial-Kipre_A.90min	player_Jean-Martial-Kipre	player_A.90min
player_Brandon-Prideaux_Club	player_Brandon-Prideaux	player_Club
player_Brandon-Prideaux_POS	player_Brandon-Prideaux	player_POS
player_Brandon-Prideaux_GP	player_Brandon-Prideaux	player_GP
player_Brandon-Prideaux_GS	player_Brandon-Prideaux	player_GS
player_Brandon-Prideaux_A	player_Brandon-Prideaux	player_A
player_Brandon-Prideaux_GWA	player_Brandon-Prideaux	player_GWA
player_Brandon-Prideaux_HmA	player_Brandon-Prideaux	player_HmA
player_Brandon-Prideaux_RdA	player_Brandon-Prideaux	player_RdA
player_Brandon-Prideaux_A.90min	player_Brandon-Prideaux	player_A.90min
player_Shavar-Thomas_Club	player_Shavar-Thomas	player_Club
player_Shavar-Thomas_POS	player_Shavar-Thomas	player_POS
player_Shavar-Thomas_GP	player_Shavar-Thomas	player_GP
player_Shavar-Thomas_GS	player_Shavar-Thomas	player_GS
player_Shavar-Thomas_A	player_Shavar-Thomas	player_A
player_Shavar-Thomas_GWA	player_Shavar-Thomas	player_GWA
player_Shavar-Thomas_HmA	player_Shavar-Thomas	player_HmA
player_Shavar-Thomas_RdA	player_Shavar-Thomas	player_RdA
player_Shavar-Thomas_A.90min	player_Shavar-Thomas	player_A.90min
player_Ty-Harden_Club	player_Ty-Harden	player_Club
player_Ty-Harden_POS	player_Ty-Harden	player_POS
player_Ty-Harden_GP	player_Ty-Harden	player_GP
player_Ty-Harden_GS	player_Ty-Harden	player_GS
player_Ty-Harden_A	player_Ty-Harden	player_A
player_Ty-Harden_GWA	player_Ty-Harden	player_GWA
player_Ty-Harden_HmA	player_Ty-Harden	player_HmA
player_Ty-Harden_RdA	player_Ty-Harden	player_RdA
player_Ty-Harden_A.90min	player_Ty-Harden	player_A.90min
