player_Tony-Sanneh_Club	player_Tony-Sanneh	player_Club
player_Tony-Sanneh_POS	player_Tony-Sanneh	player_POS
player_Tony-Sanneh_GP	player_Tony-Sanneh	player_GP
player_Tony-Sanneh_GS	player_Tony-Sanneh	player_GS
player_Tony-Sanneh_A	player_Tony-Sanneh	player_A
player_Tony-Sanneh_GWA	player_Tony-Sanneh	player_GWA
player_Tony-Sanneh_HmA	player_Tony-Sanneh	player_HmA
player_Tony-Sanneh_RdA	player_Tony-Sanneh	player_RdA
player_Tony-Sanneh_A.90min	player_Tony-Sanneh	player_A.90min
player_Diego-Sonora_Club	player_Diego-Sonora	player_Club
player_Diego-Sonora_POS	player_Diego-Sonora	player_POS
player_Diego-Sonora_GP	player_Diego-Sonora	player_GP
player_Diego-Sonora_GS	player_Diego-Sonora	player_GS
player_Diego-Sonora_A	player_Diego-Sonora	player_A
player_Diego-Sonora_GWA	player_Diego-Sonora	player_GWA
player_Diego-Sonora_HmA	player_Diego-Sonora	player_HmA
player_Diego-Sonora_RdA	player_Diego-Sonora	player_RdA
player_Diego-Sonora_A.90min	player_Diego-Sonora	player_A.90min
player_Ivan-McKinley_Club	player_Ivan-McKinley	player_Club
player_Ivan-McKinley_POS	player_Ivan-McKinley	player_POS
player_Ivan-McKinley_GP	player_Ivan-McKinley	player_GP
player_Ivan-McKinley_GS	player_Ivan-McKinley	player_GS
player_Ivan-McKinley_A	player_Ivan-McKinley	player_A
player_Ivan-McKinley_GWA	player_Ivan-McKinley	player_GWA
player_Ivan-McKinley_HmA	player_Ivan-McKinley	player_HmA
player_Ivan-McKinley_RdA	player_Ivan-McKinley	player_RdA
player_Ivan-McKinley_A.90min	player_Ivan-McKinley	player_A.90min
player_Steve-Pittman_Club	player_Steve-Pittman	player_Club
player_Steve-Pittman_POS	player_Steve-Pittman	player_POS
player_Steve-Pittman_GP	player_Steve-Pittman	player_GP
player_Steve-Pittman_GS	player_Steve-Pittman	player_GS
player_Steve-Pittman_A	player_Steve-Pittman	player_A
player_Steve-Pittman_GWA	player_Steve-Pittman	player_GWA
player_Steve-Pittman_HmA	player_Steve-Pittman	player_HmA
player_Steve-Pittman_RdA	player_Steve-Pittman	player_RdA
player_Steve-Pittman_A.90min	player_Steve-Pittman	player_A.90min
player_Jeff-Agoos_Club	player_Jeff-Agoos	player_Club
player_Jeff-Agoos_POS	player_Jeff-Agoos	player_POS
player_Jeff-Agoos_GP	player_Jeff-Agoos	player_GP
player_Jeff-Agoos_GS	player_Jeff-Agoos	player_GS
player_Jeff-Agoos_A	player_Jeff-Agoos	player_A
player_Jeff-Agoos_GWA	player_Jeff-Agoos	player_GWA
player_Jeff-Agoos_HmA	player_Jeff-Agoos	player_HmA
player_Jeff-Agoos_RdA	player_Jeff-Agoos	player_RdA
player_Jeff-Agoos_A.90min	player_Jeff-Agoos	player_A.90min
player_John-DeBrito_Club	player_John-DeBrito	player_Club
player_John-DeBrito_POS	player_John-DeBrito	player_POS
player_John-DeBrito_GP	player_John-DeBrito	player_GP
player_John-DeBrito_GS	player_John-DeBrito	player_GS
player_John-DeBrito_A	player_John-DeBrito	player_A
player_John-DeBrito_GWA	player_John-DeBrito	player_GWA
player_John-DeBrito_HmA	player_John-DeBrito	player_HmA
player_John-DeBrito_RdA	player_John-DeBrito	player_RdA
player_John-DeBrito_A.90min	player_John-DeBrito	player_A.90min
player_Diego-Gutierrez_Club	player_Diego-Gutierrez	player_Club
player_Diego-Gutierrez_POS	player_Diego-Gutierrez	player_POS
player_Diego-Gutierrez_GP	player_Diego-Gutierrez	player_GP
player_Diego-Gutierrez_GS	player_Diego-Gutierrez	player_GS
player_Diego-Gutierrez_A	player_Diego-Gutierrez	player_A
player_Diego-Gutierrez_GWA	player_Diego-Gutierrez	player_GWA
player_Diego-Gutierrez_HmA	player_Diego-Gutierrez	player_HmA
player_Diego-Gutierrez_RdA	player_Diego-Gutierrez	player_RdA
player_Diego-Gutierrez_A.90min	player_Diego-Gutierrez	player_A.90min
player_Peter-Woodring_Club	player_Peter-Woodring	player_Club
player_Peter-Woodring_POS	player_Peter-Woodring	player_POS
player_Peter-Woodring_GP	player_Peter-Woodring	player_GP
player_Peter-Woodring_GS	player_Peter-Woodring	player_GS
player_Peter-Woodring_A	player_Peter-Woodring	player_A
player_Peter-Woodring_GWA	player_Peter-Woodring	player_GWA
player_Peter-Woodring_HmA	player_Peter-Woodring	player_HmA
player_Peter-Woodring_RdA	player_Peter-Woodring	player_RdA
player_Peter-Woodring_A.90min	player_Peter-Woodring	player_A.90min
player_Mario-Gori_Club	player_Mario-Gori	player_Club
player_Mario-Gori_POS	player_Mario-Gori	player_POS
player_Mario-Gori_GP	player_Mario-Gori	player_GP
player_Mario-Gori_GS	player_Mario-Gori	player_GS
player_Mario-Gori_A	player_Mario-Gori	player_A
player_Mario-Gori_GWA	player_Mario-Gori	player_GWA
player_Mario-Gori_HmA	player_Mario-Gori	player_HmA
player_Mario-Gori_RdA	player_Mario-Gori	player_RdA
player_Mario-Gori_A.90min	player_Mario-Gori	player_A.90min
player_Cle-Kooiman_Club	player_Cle-Kooiman	player_Club
player_Cle-Kooiman_POS	player_Cle-Kooiman	player_POS
player_Cle-Kooiman_GP	player_Cle-Kooiman	player_GP
player_Cle-Kooiman_GS	player_Cle-Kooiman	player_GS
player_Cle-Kooiman_A	player_Cle-Kooiman	player_A
player_Cle-Kooiman_GWA	player_Cle-Kooiman	player_GWA
player_Cle-Kooiman_HmA	player_Cle-Kooiman	player_HmA
player_Cle-Kooiman_RdA	player_Cle-Kooiman	player_RdA
player_Cle-Kooiman_A.90min	player_Cle-Kooiman	player_A.90min
player_Geoff-Aunger_Club	player_Geoff-Aunger	player_Club
player_Geoff-Aunger_POS	player_Geoff-Aunger	player_POS
player_Geoff-Aunger_GP	player_Geoff-Aunger	player_GP
player_Geoff-Aunger_GS	player_Geoff-Aunger	player_GS
player_Geoff-Aunger_A	player_Geoff-Aunger	player_A
player_Geoff-Aunger_GWA	player_Geoff-Aunger	player_GWA
player_Geoff-Aunger_HmA	player_Geoff-Aunger	player_HmA
player_Geoff-Aunger_RdA	player_Geoff-Aunger	player_RdA
player_Geoff-Aunger_A.90min	player_Geoff-Aunger	player_A.90min
player_Sean-Bowers_Club	player_Sean-Bowers	player_Club
player_Sean-Bowers_POS	player_Sean-Bowers	player_POS
player_Sean-Bowers_GP	player_Sean-Bowers	player_GP
player_Sean-Bowers_GS	player_Sean-Bowers	player_GS
player_Sean-Bowers_A	player_Sean-Bowers	player_A
player_Sean-Bowers_GWA	player_Sean-Bowers	player_GWA
player_Sean-Bowers_HmA	player_Sean-Bowers	player_HmA
player_Sean-Bowers_RdA	player_Sean-Bowers	player_RdA
player_Sean-Bowers_A.90min	player_Sean-Bowers	player_A.90min
player_John-Maessner_Club	player_John-Maessner	player_Club
player_John-Maessner_POS	player_John-Maessner	player_POS
player_John-Maessner_GP	player_John-Maessner	player_GP
player_John-Maessner_GS	player_John-Maessner	player_GS
player_John-Maessner_A	player_John-Maessner	player_A
player_John-Maessner_GWA	player_John-Maessner	player_GWA
player_John-Maessner_HmA	player_John-Maessner	player_HmA
player_John-Maessner_RdA	player_John-Maessner	player_RdA
player_John-Maessner_A.90min	player_John-Maessner	player_A.90min
player_Frankie-Hejduk_Club	player_Frankie-Hejduk	player_Club
player_Frankie-Hejduk_POS	player_Frankie-Hejduk	player_POS
player_Frankie-Hejduk_GP	player_Frankie-Hejduk	player_GP
player_Frankie-Hejduk_GS	player_Frankie-Hejduk	player_GS
player_Frankie-Hejduk_A	player_Frankie-Hejduk	player_A
player_Frankie-Hejduk_GWA	player_Frankie-Hejduk	player_GWA
player_Frankie-Hejduk_HmA	player_Frankie-Hejduk	player_HmA
player_Frankie-Hejduk_RdA	player_Frankie-Hejduk	player_RdA
player_Frankie-Hejduk_A.90min	player_Frankie-Hejduk	player_A.90min
player_Ricardo-Iribarren_Club	player_Ricardo-Iribarren	player_Club
player_Ricardo-Iribarren_POS	player_Ricardo-Iribarren	player_POS
player_Ricardo-Iribarren_GP	player_Ricardo-Iribarren	player_GP
player_Ricardo-Iribarren_GS	player_Ricardo-Iribarren	player_GS
player_Ricardo-Iribarren_A	player_Ricardo-Iribarren	player_A
player_Ricardo-Iribarren_GWA	player_Ricardo-Iribarren	player_GWA
player_Ricardo-Iribarren_HmA	player_Ricardo-Iribarren	player_HmA
player_Ricardo-Iribarren_RdA	player_Ricardo-Iribarren	player_RdA
player_Ricardo-Iribarren_A.90min	player_Ricardo-Iribarren	player_A.90min
player_Paul-Caligiuri_Club	player_Paul-Caligiuri	player_Club
player_Paul-Caligiuri_POS	player_Paul-Caligiuri	player_POS
player_Paul-Caligiuri_GP	player_Paul-Caligiuri	player_GP
player_Paul-Caligiuri_GS	player_Paul-Caligiuri	player_GS
player_Paul-Caligiuri_A	player_Paul-Caligiuri	player_A
player_Paul-Caligiuri_GWA	player_Paul-Caligiuri	player_GWA
player_Paul-Caligiuri_HmA	player_Paul-Caligiuri	player_HmA
player_Paul-Caligiuri_RdA	player_Paul-Caligiuri	player_RdA
player_Paul-Caligiuri_A.90min	player_Paul-Caligiuri	player_A.90min
player_Ryan-Tinsley_Club	player_Ryan-Tinsley	player_Club
player_Ryan-Tinsley_POS	player_Ryan-Tinsley	player_POS
player_Ryan-Tinsley_GP	player_Ryan-Tinsley	player_GP
player_Ryan-Tinsley_GS	player_Ryan-Tinsley	player_GS
player_Ryan-Tinsley_A	player_Ryan-Tinsley	player_A
player_Ryan-Tinsley_GWA	player_Ryan-Tinsley	player_GWA
player_Ryan-Tinsley_HmA	player_Ryan-Tinsley	player_HmA
player_Ryan-Tinsley_RdA	player_Ryan-Tinsley	player_RdA
player_Ryan-Tinsley_A.90min	player_Ryan-Tinsley	player_A.90min
player_Arnold-Cruz_Club	player_Arnold-Cruz	player_Club
player_Arnold-Cruz_POS	player_Arnold-Cruz	player_POS
player_Arnold-Cruz_GP	player_Arnold-Cruz	player_GP
player_Arnold-Cruz_GS	player_Arnold-Cruz	player_GS
player_Arnold-Cruz_A	player_Arnold-Cruz	player_A
player_Arnold-Cruz_GWA	player_Arnold-Cruz	player_GWA
player_Arnold-Cruz_HmA	player_Arnold-Cruz	player_HmA
player_Arnold-Cruz_RdA	player_Arnold-Cruz	player_RdA
player_Arnold-Cruz_A.90min	player_Arnold-Cruz	player_A.90min
player_Uche-Okafor_Club	player_Uche-Okafor	player_Club
player_Uche-Okafor_POS	player_Uche-Okafor	player_POS
player_Uche-Okafor_GP	player_Uche-Okafor	player_GP
player_Uche-Okafor_GS	player_Uche-Okafor	player_GS
player_Uche-Okafor_A	player_Uche-Okafor	player_A
player_Uche-Okafor_GWA	player_Uche-Okafor	player_GWA
player_Uche-Okafor_HmA	player_Uche-Okafor	player_HmA
player_Uche-Okafor_RdA	player_Uche-Okafor	player_RdA
player_Uche-Okafor_A.90min	player_Uche-Okafor	player_A.90min
player_Alexi-Lalas_Club	player_Alexi-Lalas	player_Club
player_Alexi-Lalas_POS	player_Alexi-Lalas	player_POS
player_Alexi-Lalas_GP	player_Alexi-Lalas	player_GP
player_Alexi-Lalas_GS	player_Alexi-Lalas	player_GS
player_Alexi-Lalas_A	player_Alexi-Lalas	player_A
player_Alexi-Lalas_GWA	player_Alexi-Lalas	player_GWA
player_Alexi-Lalas_HmA	player_Alexi-Lalas	player_HmA
player_Alexi-Lalas_RdA	player_Alexi-Lalas	player_RdA
player_Alexi-Lalas_A.90min	player_Alexi-Lalas	player_A.90min
player_Branco_Club	player_Branco	player_Club
player_Branco_POS	player_Branco	player_POS
player_Branco_GP	player_Branco	player_GP
player_Branco_GS	player_Branco	player_GS
player_Branco_A	player_Branco	player_A
player_Branco_GWA	player_Branco	player_GWA
player_Branco_HmA	player_Branco	player_HmA
player_Branco_RdA	player_Branco	player_RdA
player_Branco_A.90min	player_Branco	player_A.90min
player_Sergio-Miguez_Club	player_Sergio-Miguez	player_Club
player_Sergio-Miguez_POS	player_Sergio-Miguez	player_POS
player_Sergio-Miguez_GP	player_Sergio-Miguez	player_GP
player_Sergio-Miguez_GS	player_Sergio-Miguez	player_GS
player_Sergio-Miguez_A	player_Sergio-Miguez	player_A
player_Sergio-Miguez_GWA	player_Sergio-Miguez	player_GWA
player_Sergio-Miguez_HmA	player_Sergio-Miguez	player_HmA
player_Sergio-Miguez_RdA	player_Sergio-Miguez	player_RdA
player_Sergio-Miguez_A.90min	player_Sergio-Miguez	player_A.90min
player_Adam-Frye_Club	player_Adam-Frye	player_Club
player_Adam-Frye_POS	player_Adam-Frye	player_POS
player_Adam-Frye_GP	player_Adam-Frye	player_GP
player_Adam-Frye_GS	player_Adam-Frye	player_GS
player_Adam-Frye_A	player_Adam-Frye	player_A
player_Adam-Frye_GWA	player_Adam-Frye	player_GWA
player_Adam-Frye_HmA	player_Adam-Frye	player_HmA
player_Adam-Frye_RdA	player_Adam-Frye	player_RdA
player_Adam-Frye_A.90min	player_Adam-Frye	player_A.90min
player_Mike-Lapper_Club	player_Mike-Lapper	player_Club
player_Mike-Lapper_POS	player_Mike-Lapper	player_POS
player_Mike-Lapper_GP	player_Mike-Lapper	player_GP
player_Mike-Lapper_GS	player_Mike-Lapper	player_GS
player_Mike-Lapper_A	player_Mike-Lapper	player_A
player_Mike-Lapper_GWA	player_Mike-Lapper	player_GWA
player_Mike-Lapper_HmA	player_Mike-Lapper	player_HmA
player_Mike-Lapper_RdA	player_Mike-Lapper	player_RdA
player_Mike-Lapper_A.90min	player_Mike-Lapper	player_A.90min
player_David-Vaudreuil_Club	player_David-Vaudreuil	player_Club
player_David-Vaudreuil_POS	player_David-Vaudreuil	player_POS
player_David-Vaudreuil_GP	player_David-Vaudreuil	player_GP
player_David-Vaudreuil_GS	player_David-Vaudreuil	player_GS
player_David-Vaudreuil_A	player_David-Vaudreuil	player_A
player_David-Vaudreuil_GWA	player_David-Vaudreuil	player_GWA
player_David-Vaudreuil_HmA	player_David-Vaudreuil	player_HmA
player_David-Vaudreuil_RdA	player_David-Vaudreuil	player_RdA
player_David-Vaudreuil_A.90min	player_David-Vaudreuil	player_A.90min
player_Tom-Soehn_Club	player_Tom-Soehn	player_Club
player_Tom-Soehn_POS	player_Tom-Soehn	player_POS
player_Tom-Soehn_GP	player_Tom-Soehn	player_GP
player_Tom-Soehn_GS	player_Tom-Soehn	player_GS
player_Tom-Soehn_A	player_Tom-Soehn	player_A
player_Tom-Soehn_GWA	player_Tom-Soehn	player_GWA
player_Tom-Soehn_HmA	player_Tom-Soehn	player_HmA
player_Tom-Soehn_RdA	player_Tom-Soehn	player_RdA
player_Tom-Soehn_A.90min	player_Tom-Soehn	player_A.90min
player_Brian-Bliss_Club	player_Brian-Bliss	player_Club
player_Brian-Bliss_POS	player_Brian-Bliss	player_POS
player_Brian-Bliss_GP	player_Brian-Bliss	player_GP
player_Brian-Bliss_GS	player_Brian-Bliss	player_GS
player_Brian-Bliss_A	player_Brian-Bliss	player_A
player_Brian-Bliss_GWA	player_Brian-Bliss	player_GWA
player_Brian-Bliss_HmA	player_Brian-Bliss	player_HmA
player_Brian-Bliss_RdA	player_Brian-Bliss	player_RdA
player_Brian-Bliss_A.90min	player_Brian-Bliss	player_A.90min
player_Mike-Clark_Club	player_Mike-Clark	player_Club
player_Mike-Clark_POS	player_Mike-Clark	player_POS
player_Mike-Clark_GP	player_Mike-Clark	player_GP
player_Mike-Clark_GS	player_Mike-Clark	player_GS
player_Mike-Clark_A	player_Mike-Clark	player_A
player_Mike-Clark_GWA	player_Mike-Clark	player_GWA
player_Mike-Clark_HmA	player_Mike-Clark	player_HmA
player_Mike-Clark_RdA	player_Mike-Clark	player_RdA
player_Mike-Clark_A.90min	player_Mike-Clark	player_A.90min
player_Eddie-Pope_Club	player_Eddie-Pope	player_Club
player_Eddie-Pope_POS	player_Eddie-Pope	player_POS
player_Eddie-Pope_GP	player_Eddie-Pope	player_GP
player_Eddie-Pope_GS	player_Eddie-Pope	player_GS
player_Eddie-Pope_A	player_Eddie-Pope	player_A
player_Eddie-Pope_GWA	player_Eddie-Pope	player_GWA
player_Eddie-Pope_HmA	player_Eddie-Pope	player_HmA
player_Eddie-Pope_RdA	player_Eddie-Pope	player_RdA
player_Eddie-Pope_A.90min	player_Eddie-Pope	player_A.90min
player_Ansil-Elcock_Club	player_Ansil-Elcock	player_Club
player_Ansil-Elcock_POS	player_Ansil-Elcock	player_POS
player_Ansil-Elcock_GP	player_Ansil-Elcock	player_GP
player_Ansil-Elcock_GS	player_Ansil-Elcock	player_GS
player_Ansil-Elcock_A	player_Ansil-Elcock	player_A
player_Ansil-Elcock_GWA	player_Ansil-Elcock	player_GWA
player_Ansil-Elcock_HmA	player_Ansil-Elcock	player_HmA
player_Ansil-Elcock_RdA	player_Ansil-Elcock	player_RdA
player_Ansil-Elcock_A.90min	player_Ansil-Elcock	player_A.90min
player_Lubos-Kubik_Club	player_Lubos-Kubik	player_Club
player_Lubos-Kubik_POS	player_Lubos-Kubik	player_POS
player_Lubos-Kubik_GP	player_Lubos-Kubik	player_GP
player_Lubos-Kubik_GS	player_Lubos-Kubik	player_GS
player_Lubos-Kubik_A	player_Lubos-Kubik	player_A
player_Lubos-Kubik_GWA	player_Lubos-Kubik	player_GWA
player_Lubos-Kubik_HmA	player_Lubos-Kubik	player_HmA
player_Lubos-Kubik_RdA	player_Lubos-Kubik	player_RdA
player_Lubos-Kubik_A.90min	player_Lubos-Kubik	player_A.90min
player_Chris-Houser_Club	player_Chris-Houser	player_Club
player_Chris-Houser_POS	player_Chris-Houser	player_POS
player_Chris-Houser_GP	player_Chris-Houser	player_GP
player_Chris-Houser_GS	player_Chris-Houser	player_GS
player_Chris-Houser_A	player_Chris-Houser	player_A
player_Chris-Houser_GWA	player_Chris-Houser	player_GWA
player_Chris-Houser_HmA	player_Chris-Houser	player_HmA
player_Chris-Houser_RdA	player_Chris-Houser	player_RdA
player_Chris-Houser_A.90min	player_Chris-Houser	player_A.90min
player_Scott-Cannon_Club	player_Scott-Cannon	player_Club
player_Scott-Cannon_POS	player_Scott-Cannon	player_POS
player_Scott-Cannon_GP	player_Scott-Cannon	player_GP
player_Scott-Cannon_GS	player_Scott-Cannon	player_GS
player_Scott-Cannon_A	player_Scott-Cannon	player_A
player_Scott-Cannon_GWA	player_Scott-Cannon	player_GWA
player_Scott-Cannon_HmA	player_Scott-Cannon	player_HmA
player_Scott-Cannon_RdA	player_Scott-Cannon	player_RdA
player_Scott-Cannon_A.90min	player_Scott-Cannon	player_A.90min
player_Scott-Vermillion_Club	player_Scott-Vermillion	player_Club
player_Scott-Vermillion_POS	player_Scott-Vermillion	player_POS
player_Scott-Vermillion_GP	player_Scott-Vermillion	player_GP
player_Scott-Vermillion_GS	player_Scott-Vermillion	player_GS
player_Scott-Vermillion_A	player_Scott-Vermillion	player_A
player_Scott-Vermillion_GWA	player_Scott-Vermillion	player_GWA
player_Scott-Vermillion_HmA	player_Scott-Vermillion	player_HmA
player_Scott-Vermillion_RdA	player_Scott-Vermillion	player_RdA
player_Scott-Vermillion_A.90min	player_Scott-Vermillion	player_A.90min
player_Ted-Chronopoulos_Club	player_Ted-Chronopoulos	player_Club
player_Ted-Chronopoulos_POS	player_Ted-Chronopoulos	player_POS
player_Ted-Chronopoulos_GP	player_Ted-Chronopoulos	player_GP
player_Ted-Chronopoulos_GS	player_Ted-Chronopoulos	player_GS
player_Ted-Chronopoulos_A	player_Ted-Chronopoulos	player_A
player_Ted-Chronopoulos_GWA	player_Ted-Chronopoulos	player_GWA
player_Ted-Chronopoulos_HmA	player_Ted-Chronopoulos	player_HmA
player_Ted-Chronopoulos_RdA	player_Ted-Chronopoulos	player_RdA
player_Ted-Chronopoulos_A.90min	player_Ted-Chronopoulos	player_A.90min
player_Ritchie-Kotschau_Club	player_Ritchie-Kotschau	player_Club
player_Ritchie-Kotschau_POS	player_Ritchie-Kotschau	player_POS
player_Ritchie-Kotschau_GP	player_Ritchie-Kotschau	player_GP
player_Ritchie-Kotschau_GS	player_Ritchie-Kotschau	player_GS
player_Ritchie-Kotschau_A	player_Ritchie-Kotschau	player_A
player_Ritchie-Kotschau_GWA	player_Ritchie-Kotschau	player_GWA
player_Ritchie-Kotschau_HmA	player_Ritchie-Kotschau	player_HmA
player_Ritchie-Kotschau_RdA	player_Ritchie-Kotschau	player_RdA
player_Ritchie-Kotschau_A.90min	player_Ritchie-Kotschau	player_A.90min
player_Francis-Okaroh_Club	player_Francis-Okaroh	player_Club
player_Francis-Okaroh_POS	player_Francis-Okaroh	player_POS
player_Francis-Okaroh_GP	player_Francis-Okaroh	player_GP
player_Francis-Okaroh_GS	player_Francis-Okaroh	player_GS
player_Francis-Okaroh_A	player_Francis-Okaroh	player_A
player_Francis-Okaroh_GWA	player_Francis-Okaroh	player_GWA
player_Francis-Okaroh_HmA	player_Francis-Okaroh	player_HmA
player_Francis-Okaroh_RdA	player_Francis-Okaroh	player_RdA
player_Francis-Okaroh_A.90min	player_Francis-Okaroh	player_A.90min
player_Mike-Duhaney_Club	player_Mike-Duhaney	player_Club
player_Mike-Duhaney_POS	player_Mike-Duhaney	player_POS
player_Mike-Duhaney_GP	player_Mike-Duhaney	player_GP
player_Mike-Duhaney_GS	player_Mike-Duhaney	player_GS
player_Mike-Duhaney_A	player_Mike-Duhaney	player_A
player_Mike-Duhaney_GWA	player_Mike-Duhaney	player_GWA
player_Mike-Duhaney_HmA	player_Mike-Duhaney	player_HmA
player_Mike-Duhaney_RdA	player_Mike-Duhaney	player_RdA
player_Mike-Duhaney_A.90min	player_Mike-Duhaney	player_A.90min
player_Manny-Motajo_Club	player_Manny-Motajo	player_Club
player_Manny-Motajo_POS	player_Manny-Motajo	player_POS
player_Manny-Motajo_GP	player_Manny-Motajo	player_GP
player_Manny-Motajo_GS	player_Manny-Motajo	player_GS
player_Manny-Motajo_A	player_Manny-Motajo	player_A
player_Manny-Motajo_GWA	player_Manny-Motajo	player_GWA
player_Manny-Motajo_HmA	player_Manny-Motajo	player_HmA
player_Manny-Motajo_RdA	player_Manny-Motajo	player_RdA
player_Manny-Motajo_A.90min	player_Manny-Motajo	player_A.90min
player_Scott-Uderitz_Club	player_Scott-Uderitz	player_Club
player_Scott-Uderitz_POS	player_Scott-Uderitz	player_POS
player_Scott-Uderitz_GP	player_Scott-Uderitz	player_GP
player_Scott-Uderitz_GS	player_Scott-Uderitz	player_GS
player_Scott-Uderitz_A	player_Scott-Uderitz	player_A
player_Scott-Uderitz_GWA	player_Scott-Uderitz	player_GWA
player_Scott-Uderitz_HmA	player_Scott-Uderitz	player_HmA
player_Scott-Uderitz_RdA	player_Scott-Uderitz	player_RdA
player_Scott-Uderitz_A.90min	player_Scott-Uderitz	player_A.90min
player_Carey-Talley_Club	player_Carey-Talley	player_Club
player_Carey-Talley_POS	player_Carey-Talley	player_POS
player_Carey-Talley_GP	player_Carey-Talley	player_GP
player_Carey-Talley_GS	player_Carey-Talley	player_GS
player_Carey-Talley_A	player_Carey-Talley	player_A
player_Carey-Talley_GWA	player_Carey-Talley	player_GWA
player_Carey-Talley_HmA	player_Carey-Talley	player_HmA
player_Carey-Talley_RdA	player_Carey-Talley	player_RdA
player_Carey-Talley_A.90min	player_Carey-Talley	player_A.90min
player_Thomas-Dooley_Club	player_Thomas-Dooley	player_Club
player_Thomas-Dooley_POS	player_Thomas-Dooley	player_POS
player_Thomas-Dooley_GP	player_Thomas-Dooley	player_GP
player_Thomas-Dooley_GS	player_Thomas-Dooley	player_GS
player_Thomas-Dooley_A	player_Thomas-Dooley	player_A
player_Thomas-Dooley_GWA	player_Thomas-Dooley	player_GWA
player_Thomas-Dooley_HmA	player_Thomas-Dooley	player_HmA
player_Thomas-Dooley_RdA	player_Thomas-Dooley	player_RdA
player_Thomas-Dooley_A.90min	player_Thomas-Dooley	player_A.90min
player_Richard-Farrer_Club	player_Richard-Farrer	player_Club
player_Richard-Farrer_POS	player_Richard-Farrer	player_POS
player_Richard-Farrer_GP	player_Richard-Farrer	player_GP
player_Richard-Farrer_GS	player_Richard-Farrer	player_GS
player_Richard-Farrer_A	player_Richard-Farrer	player_A
player_Richard-Farrer_GWA	player_Richard-Farrer	player_GWA
player_Richard-Farrer_HmA	player_Richard-Farrer	player_HmA
player_Richard-Farrer_RdA	player_Richard-Farrer	player_RdA
player_Richard-Farrer_A.90min	player_Richard-Farrer	player_A.90min
player_Matt-Kmosko_Club	player_Matt-Kmosko	player_Club
player_Matt-Kmosko_POS	player_Matt-Kmosko	player_POS
player_Matt-Kmosko_GP	player_Matt-Kmosko	player_GP
player_Matt-Kmosko_GS	player_Matt-Kmosko	player_GS
player_Matt-Kmosko_A	player_Matt-Kmosko	player_A
player_Matt-Kmosko_GWA	player_Matt-Kmosko	player_GWA
player_Matt-Kmosko_HmA	player_Matt-Kmosko	player_HmA
player_Matt-Kmosko_RdA	player_Matt-Kmosko	player_RdA
player_Matt-Kmosko_A.90min	player_Matt-Kmosko	player_A.90min
player_Richard-Goulooze_Club	player_Richard-Goulooze	player_Club
player_Richard-Goulooze_POS	player_Richard-Goulooze	player_POS
player_Richard-Goulooze_GP	player_Richard-Goulooze	player_GP
player_Richard-Goulooze_GS	player_Richard-Goulooze	player_GS
player_Richard-Goulooze_A	player_Richard-Goulooze	player_A
player_Richard-Goulooze_GWA	player_Richard-Goulooze	player_GWA
player_Richard-Goulooze_HmA	player_Richard-Goulooze	player_HmA
player_Richard-Goulooze_RdA	player_Richard-Goulooze	player_RdA
player_Richard-Goulooze_A.90min	player_Richard-Goulooze	player_A.90min
player_Jorge-Rodriguez_Club	player_Jorge-Rodriguez	player_Club
player_Jorge-Rodriguez_POS	player_Jorge-Rodriguez	player_POS
player_Jorge-Rodriguez_GP	player_Jorge-Rodriguez	player_GP
player_Jorge-Rodriguez_GS	player_Jorge-Rodriguez	player_GS
player_Jorge-Rodriguez_A	player_Jorge-Rodriguez	player_A
player_Jorge-Rodriguez_GWA	player_Jorge-Rodriguez	player_GWA
player_Jorge-Rodriguez_HmA	player_Jorge-Rodriguez	player_HmA
player_Jorge-Rodriguez_RdA	player_Jorge-Rodriguez	player_RdA
player_Jorge-Rodriguez_A.90min	player_Jorge-Rodriguez	player_A.90min
player_Tyrone-Marshall_Club	player_Tyrone-Marshall	player_Club
player_Tyrone-Marshall_POS	player_Tyrone-Marshall	player_POS
player_Tyrone-Marshall_GP	player_Tyrone-Marshall	player_GP
player_Tyrone-Marshall_GS	player_Tyrone-Marshall	player_GS
player_Tyrone-Marshall_A	player_Tyrone-Marshall	player_A
player_Tyrone-Marshall_GWA	player_Tyrone-Marshall	player_GWA
player_Tyrone-Marshall_HmA	player_Tyrone-Marshall	player_HmA
player_Tyrone-Marshall_RdA	player_Tyrone-Marshall	player_RdA
player_Tyrone-Marshall_A.90min	player_Tyrone-Marshall	player_A.90min
player_Tim-Sahaydak_Club	player_Tim-Sahaydak	player_Club
player_Tim-Sahaydak_POS	player_Tim-Sahaydak	player_POS
player_Tim-Sahaydak_GP	player_Tim-Sahaydak	player_GP
player_Tim-Sahaydak_GS	player_Tim-Sahaydak	player_GS
player_Tim-Sahaydak_A	player_Tim-Sahaydak	player_A
player_Tim-Sahaydak_GWA	player_Tim-Sahaydak	player_GWA
player_Tim-Sahaydak_HmA	player_Tim-Sahaydak	player_HmA
player_Tim-Sahaydak_RdA	player_Tim-Sahaydak	player_RdA
player_Tim-Sahaydak_A.90min	player_Tim-Sahaydak	player_A.90min
player_Nansha-Kalonji_Club	player_Nansha-Kalonji	player_Club
player_Nansha-Kalonji_POS	player_Nansha-Kalonji	player_POS
player_Nansha-Kalonji_GP	player_Nansha-Kalonji	player_GP
player_Nansha-Kalonji_GS	player_Nansha-Kalonji	player_GS
player_Nansha-Kalonji_A	player_Nansha-Kalonji	player_A
player_Nansha-Kalonji_GWA	player_Nansha-Kalonji	player_GWA
player_Nansha-Kalonji_HmA	player_Nansha-Kalonji	player_HmA
player_Nansha-Kalonji_RdA	player_Nansha-Kalonji	player_RdA
player_Nansha-Kalonji_A.90min	player_Nansha-Kalonji	player_A.90min
player_C.J.-Brown_Club	player_C.J.-Brown	player_Club
player_C.J.-Brown_POS	player_C.J.-Brown	player_POS
player_C.J.-Brown_GP	player_C.J.-Brown	player_GP
player_C.J.-Brown_GS	player_C.J.-Brown	player_GS
player_C.J.-Brown_A	player_C.J.-Brown	player_A
player_C.J.-Brown_GWA	player_C.J.-Brown	player_GWA
player_C.J.-Brown_HmA	player_C.J.-Brown	player_HmA
player_C.J.-Brown_RdA	player_C.J.-Brown	player_RdA
player_C.J.-Brown_A.90min	player_C.J.-Brown	player_A.90min
player_Brandon-Pollard_Club	player_Brandon-Pollard	player_Club
player_Brandon-Pollard_POS	player_Brandon-Pollard	player_POS
player_Brandon-Pollard_GP	player_Brandon-Pollard	player_GP
player_Brandon-Pollard_GS	player_Brandon-Pollard	player_GS
player_Brandon-Pollard_A	player_Brandon-Pollard	player_A
player_Brandon-Pollard_GWA	player_Brandon-Pollard	player_GWA
player_Brandon-Pollard_HmA	player_Brandon-Pollard	player_HmA
player_Brandon-Pollard_RdA	player_Brandon-Pollard	player_RdA
player_Brandon-Pollard_A.90min	player_Brandon-Pollard	player_A.90min
player_Matt-McKeon_Club	player_Matt-McKeon	player_Club
player_Matt-McKeon_POS	player_Matt-McKeon	player_POS
player_Matt-McKeon_GP	player_Matt-McKeon	player_GP
player_Matt-McKeon_GS	player_Matt-McKeon	player_GS
player_Matt-McKeon_A	player_Matt-McKeon	player_A
player_Matt-McKeon_GWA	player_Matt-McKeon	player_GWA
player_Matt-McKeon_HmA	player_Matt-McKeon	player_HmA
player_Matt-McKeon_RdA	player_Matt-McKeon	player_RdA
player_Matt-McKeon_A.90min	player_Matt-McKeon	player_A.90min
player_Evan-Whitfield_Club	player_Evan-Whitfield	player_Club
player_Evan-Whitfield_POS	player_Evan-Whitfield	player_POS
player_Evan-Whitfield_GP	player_Evan-Whitfield	player_GP
player_Evan-Whitfield_GS	player_Evan-Whitfield	player_GS
player_Evan-Whitfield_A	player_Evan-Whitfield	player_A
player_Evan-Whitfield_GWA	player_Evan-Whitfield	player_GWA
player_Evan-Whitfield_HmA	player_Evan-Whitfield	player_HmA
player_Evan-Whitfield_RdA	player_Evan-Whitfield	player_RdA
player_Evan-Whitfield_A.90min	player_Evan-Whitfield	player_A.90min
player_Jay-Heaps_Club	player_Jay-Heaps	player_Club
player_Jay-Heaps_POS	player_Jay-Heaps	player_POS
player_Jay-Heaps_GP	player_Jay-Heaps	player_GP
player_Jay-Heaps_GS	player_Jay-Heaps	player_GS
player_Jay-Heaps_A	player_Jay-Heaps	player_A
player_Jay-Heaps_GWA	player_Jay-Heaps	player_GWA
player_Jay-Heaps_HmA	player_Jay-Heaps	player_HmA
player_Jay-Heaps_RdA	player_Jay-Heaps	player_RdA
player_Jay-Heaps_A.90min	player_Jay-Heaps	player_A.90min
player_Chad-McCarty_Club	player_Chad-McCarty	player_Club
player_Chad-McCarty_POS	player_Chad-McCarty	player_POS
player_Chad-McCarty_GP	player_Chad-McCarty	player_GP
player_Chad-McCarty_GS	player_Chad-McCarty	player_GS
player_Chad-McCarty_A	player_Chad-McCarty	player_A
player_Chad-McCarty_GWA	player_Chad-McCarty	player_GWA
player_Chad-McCarty_HmA	player_Chad-McCarty	player_HmA
player_Chad-McCarty_RdA	player_Chad-McCarty	player_RdA
player_Chad-McCarty_A.90min	player_Chad-McCarty	player_A.90min
player_Lothar-Matthaus_Club	player_Lothar-Matthaus	player_Club
player_Lothar-Matthaus_POS	player_Lothar-Matthaus	player_POS
player_Lothar-Matthaus_GP	player_Lothar-Matthaus	player_GP
player_Lothar-Matthaus_GS	player_Lothar-Matthaus	player_GS
player_Lothar-Matthaus_A	player_Lothar-Matthaus	player_A
player_Lothar-Matthaus_GWA	player_Lothar-Matthaus	player_GWA
player_Lothar-Matthaus_HmA	player_Lothar-Matthaus	player_HmA
player_Lothar-Matthaus_RdA	player_Lothar-Matthaus	player_RdA
player_Lothar-Matthaus_A.90min	player_Lothar-Matthaus	player_A.90min
player_Peter-Vermes_Club	player_Peter-Vermes	player_Club
player_Peter-Vermes_POS	player_Peter-Vermes	player_POS
player_Peter-Vermes_GP	player_Peter-Vermes	player_GP
player_Peter-Vermes_GS	player_Peter-Vermes	player_GS
player_Peter-Vermes_A	player_Peter-Vermes	player_A
player_Peter-Vermes_GWA	player_Peter-Vermes	player_GWA
player_Peter-Vermes_HmA	player_Peter-Vermes	player_HmA
player_Peter-Vermes_RdA	player_Peter-Vermes	player_RdA
player_Peter-Vermes_A.90min	player_Peter-Vermes	player_A.90min
player_DaMarcus-Beasley_Club	player_DaMarcus-Beasley	player_Club
player_DaMarcus-Beasley_POS	player_DaMarcus-Beasley	player_POS
player_DaMarcus-Beasley_GP	player_DaMarcus-Beasley	player_GP
player_DaMarcus-Beasley_GS	player_DaMarcus-Beasley	player_GS
player_DaMarcus-Beasley_A	player_DaMarcus-Beasley	player_A
player_DaMarcus-Beasley_GWA	player_DaMarcus-Beasley	player_GWA
player_DaMarcus-Beasley_HmA	player_DaMarcus-Beasley	player_HmA
player_DaMarcus-Beasley_RdA	player_DaMarcus-Beasley	player_RdA
player_DaMarcus-Beasley_A.90min	player_DaMarcus-Beasley	player_A.90min
player_Eric-Dade_Club	player_Eric-Dade	player_Club
player_Eric-Dade_POS	player_Eric-Dade	player_POS
player_Eric-Dade_GP	player_Eric-Dade	player_GP
player_Eric-Dade_GS	player_Eric-Dade	player_GS
player_Eric-Dade_A	player_Eric-Dade	player_A
player_Eric-Dade_GWA	player_Eric-Dade	player_GWA
player_Eric-Dade_HmA	player_Eric-Dade	player_HmA
player_Eric-Dade_RdA	player_Eric-Dade	player_RdA
player_Eric-Dade_A.90min	player_Eric-Dade	player_A.90min
player_Bryan-Namoff_Club	player_Bryan-Namoff	player_Club
player_Bryan-Namoff_POS	player_Bryan-Namoff	player_POS
player_Bryan-Namoff_GP	player_Bryan-Namoff	player_GP
player_Bryan-Namoff_GS	player_Bryan-Namoff	player_GS
player_Bryan-Namoff_A	player_Bryan-Namoff	player_A
player_Bryan-Namoff_GWA	player_Bryan-Namoff	player_GWA
player_Bryan-Namoff_HmA	player_Bryan-Namoff	player_HmA
player_Bryan-Namoff_RdA	player_Bryan-Namoff	player_RdA
player_Bryan-Namoff_A.90min	player_Bryan-Namoff	player_A.90min
player_Eric-Denton_Club	player_Eric-Denton	player_Club
player_Eric-Denton_POS	player_Eric-Denton	player_POS
player_Eric-Denton_GP	player_Eric-Denton	player_GP
player_Eric-Denton_GS	player_Eric-Denton	player_GS
player_Eric-Denton_A	player_Eric-Denton	player_A
player_Eric-Denton_GWA	player_Eric-Denton	player_GWA
player_Eric-Denton_HmA	player_Eric-Denton	player_HmA
player_Eric-Denton_RdA	player_Eric-Denton	player_RdA
player_Eric-Denton_A.90min	player_Eric-Denton	player_A.90min
player_Craig-Ziadie_Club	player_Craig-Ziadie	player_Club
player_Craig-Ziadie_POS	player_Craig-Ziadie	player_POS
player_Craig-Ziadie_GP	player_Craig-Ziadie	player_GP
player_Craig-Ziadie_GS	player_Craig-Ziadie	player_GS
player_Craig-Ziadie_A	player_Craig-Ziadie	player_A
player_Craig-Ziadie_GWA	player_Craig-Ziadie	player_GWA
player_Craig-Ziadie_HmA	player_Craig-Ziadie	player_HmA
player_Craig-Ziadie_RdA	player_Craig-Ziadie	player_RdA
player_Craig-Ziadie_A.90min	player_Craig-Ziadie	player_A.90min
player_Ryan-Suarez_Club	player_Ryan-Suarez	player_Club
player_Ryan-Suarez_POS	player_Ryan-Suarez	player_POS
player_Ryan-Suarez_GP	player_Ryan-Suarez	player_GP
player_Ryan-Suarez_GS	player_Ryan-Suarez	player_GS
player_Ryan-Suarez_A	player_Ryan-Suarez	player_A
player_Ryan-Suarez_GWA	player_Ryan-Suarez	player_GWA
player_Ryan-Suarez_HmA	player_Ryan-Suarez	player_HmA
player_Ryan-Suarez_RdA	player_Ryan-Suarez	player_RdA
player_Ryan-Suarez_A.90min	player_Ryan-Suarez	player_A.90min
player_Tenywa-Bonseu_Club	player_Tenywa-Bonseu	player_Club
player_Tenywa-Bonseu_POS	player_Tenywa-Bonseu	player_POS
player_Tenywa-Bonseu_GP	player_Tenywa-Bonseu	player_GP
player_Tenywa-Bonseu_GS	player_Tenywa-Bonseu	player_GS
player_Tenywa-Bonseu_A	player_Tenywa-Bonseu	player_A
player_Tenywa-Bonseu_GWA	player_Tenywa-Bonseu	player_GWA
player_Tenywa-Bonseu_HmA	player_Tenywa-Bonseu	player_HmA
player_Tenywa-Bonseu_RdA	player_Tenywa-Bonseu	player_RdA
player_Tenywa-Bonseu_A.90min	player_Tenywa-Bonseu	player_A.90min
player_Steve-Jolley_Club	player_Steve-Jolley	player_Club
player_Steve-Jolley_POS	player_Steve-Jolley	player_POS
player_Steve-Jolley_GP	player_Steve-Jolley	player_GP
player_Steve-Jolley_GS	player_Steve-Jolley	player_GS
player_Steve-Jolley_A	player_Steve-Jolley	player_A
player_Steve-Jolley_GWA	player_Steve-Jolley	player_GWA
player_Steve-Jolley_HmA	player_Steve-Jolley	player_HmA
player_Steve-Jolley_RdA	player_Steve-Jolley	player_RdA
player_Steve-Jolley_A.90min	player_Steve-Jolley	player_A.90min
player_Mark-Watson_Club	player_Mark-Watson	player_Club
player_Mark-Watson_POS	player_Mark-Watson	player_POS
player_Mark-Watson_GP	player_Mark-Watson	player_GP
player_Mark-Watson_GS	player_Mark-Watson	player_GS
player_Mark-Watson_A	player_Mark-Watson	player_A
player_Mark-Watson_GWA	player_Mark-Watson	player_GWA
player_Mark-Watson_HmA	player_Mark-Watson	player_HmA
player_Mark-Watson_RdA	player_Mark-Watson	player_RdA
player_Mark-Watson_A.90min	player_Mark-Watson	player_A.90min
player_Carlos-Bocanegra_Club	player_Carlos-Bocanegra	player_Club
player_Carlos-Bocanegra_POS	player_Carlos-Bocanegra	player_POS
player_Carlos-Bocanegra_GP	player_Carlos-Bocanegra	player_GP
player_Carlos-Bocanegra_GS	player_Carlos-Bocanegra	player_GS
player_Carlos-Bocanegra_A	player_Carlos-Bocanegra	player_A
player_Carlos-Bocanegra_GWA	player_Carlos-Bocanegra	player_GWA
player_Carlos-Bocanegra_HmA	player_Carlos-Bocanegra	player_HmA
player_Carlos-Bocanegra_RdA	player_Carlos-Bocanegra	player_RdA
player_Carlos-Bocanegra_A.90min	player_Carlos-Bocanegra	player_A.90min
player_Steve-Trittschuh_Club	player_Steve-Trittschuh	player_Club
player_Steve-Trittschuh_POS	player_Steve-Trittschuh	player_POS
player_Steve-Trittschuh_GP	player_Steve-Trittschuh	player_GP
player_Steve-Trittschuh_GS	player_Steve-Trittschuh	player_GS
player_Steve-Trittschuh_A	player_Steve-Trittschuh	player_A
player_Steve-Trittschuh_GWA	player_Steve-Trittschuh	player_GWA
player_Steve-Trittschuh_HmA	player_Steve-Trittschuh	player_HmA
player_Steve-Trittschuh_RdA	player_Steve-Trittschuh	player_RdA
player_Steve-Trittschuh_A.90min	player_Steve-Trittschuh	player_A.90min
player_Ryan-Nelsen_Club	player_Ryan-Nelsen	player_Club
player_Ryan-Nelsen_POS	player_Ryan-Nelsen	player_POS
player_Ryan-Nelsen_GP	player_Ryan-Nelsen	player_GP
player_Ryan-Nelsen_GS	player_Ryan-Nelsen	player_GS
player_Ryan-Nelsen_A	player_Ryan-Nelsen	player_A
player_Ryan-Nelsen_GWA	player_Ryan-Nelsen	player_GWA
player_Ryan-Nelsen_HmA	player_Ryan-Nelsen	player_HmA
player_Ryan-Nelsen_RdA	player_Ryan-Nelsen	player_RdA
player_Ryan-Nelsen_A.90min	player_Ryan-Nelsen	player_A.90min
player_Kelly-Gray_Club	player_Kelly-Gray	player_Club
player_Kelly-Gray_POS	player_Kelly-Gray	player_POS
player_Kelly-Gray_GP	player_Kelly-Gray	player_GP
player_Kelly-Gray_GS	player_Kelly-Gray	player_GS
player_Kelly-Gray_A	player_Kelly-Gray	player_A
player_Kelly-Gray_GWA	player_Kelly-Gray	player_GWA
player_Kelly-Gray_HmA	player_Kelly-Gray	player_HmA
player_Kelly-Gray_RdA	player_Kelly-Gray	player_RdA
player_Kelly-Gray_A.90min	player_Kelly-Gray	player_A.90min
player_Duncan-Oughton_Club	player_Duncan-Oughton	player_Club
player_Duncan-Oughton_POS	player_Duncan-Oughton	player_POS
player_Duncan-Oughton_GP	player_Duncan-Oughton	player_GP
player_Duncan-Oughton_GS	player_Duncan-Oughton	player_GS
player_Duncan-Oughton_A	player_Duncan-Oughton	player_A
player_Duncan-Oughton_GWA	player_Duncan-Oughton	player_GWA
player_Duncan-Oughton_HmA	player_Duncan-Oughton	player_HmA
player_Duncan-Oughton_RdA	player_Duncan-Oughton	player_RdA
player_Duncan-Oughton_A.90min	player_Duncan-Oughton	player_A.90min
player_Milton-Reyes_Club	player_Milton-Reyes	player_Club
player_Milton-Reyes_POS	player_Milton-Reyes	player_POS
player_Milton-Reyes_GP	player_Milton-Reyes	player_GP
player_Milton-Reyes_GS	player_Milton-Reyes	player_GS
player_Milton-Reyes_A	player_Milton-Reyes	player_A
player_Milton-Reyes_GWA	player_Milton-Reyes	player_GWA
player_Milton-Reyes_HmA	player_Milton-Reyes	player_HmA
player_Milton-Reyes_RdA	player_Milton-Reyes	player_RdA
player_Milton-Reyes_A.90min	player_Milton-Reyes	player_A.90min
player_Nick-Garcia_Club	player_Nick-Garcia	player_Club
player_Nick-Garcia_POS	player_Nick-Garcia	player_POS
player_Nick-Garcia_GP	player_Nick-Garcia	player_GP
player_Nick-Garcia_GS	player_Nick-Garcia	player_GS
player_Nick-Garcia_A	player_Nick-Garcia	player_A
player_Nick-Garcia_GWA	player_Nick-Garcia	player_GWA
player_Nick-Garcia_HmA	player_Nick-Garcia	player_HmA
player_Nick-Garcia_RdA	player_Nick-Garcia	player_RdA
player_Nick-Garcia_A.90min	player_Nick-Garcia	player_A.90min
player_Brian-Dunseth_Club	player_Brian-Dunseth	player_Club
player_Brian-Dunseth_POS	player_Brian-Dunseth	player_POS
player_Brian-Dunseth_GP	player_Brian-Dunseth	player_GP
player_Brian-Dunseth_GS	player_Brian-Dunseth	player_GS
player_Brian-Dunseth_A	player_Brian-Dunseth	player_A
player_Brian-Dunseth_GWA	player_Brian-Dunseth	player_GWA
player_Brian-Dunseth_HmA	player_Brian-Dunseth	player_HmA
player_Brian-Dunseth_RdA	player_Brian-Dunseth	player_RdA
player_Brian-Dunseth_A.90min	player_Brian-Dunseth	player_A.90min
player_Jake-Traeger_Club	player_Jake-Traeger	player_Club
player_Jake-Traeger_POS	player_Jake-Traeger	player_POS
player_Jake-Traeger_GP	player_Jake-Traeger	player_GP
player_Jake-Traeger_GS	player_Jake-Traeger	player_GS
player_Jake-Traeger_A	player_Jake-Traeger	player_A
player_Jake-Traeger_GWA	player_Jake-Traeger	player_GWA
player_Jake-Traeger_HmA	player_Jake-Traeger	player_HmA
player_Jake-Traeger_RdA	player_Jake-Traeger	player_RdA
player_Jake-Traeger_A.90min	player_Jake-Traeger	player_A.90min
player_Chris-Gbandi_Club	player_Chris-Gbandi	player_Club
player_Chris-Gbandi_POS	player_Chris-Gbandi	player_POS
player_Chris-Gbandi_GP	player_Chris-Gbandi	player_GP
player_Chris-Gbandi_GS	player_Chris-Gbandi	player_GS
player_Chris-Gbandi_A	player_Chris-Gbandi	player_A
player_Chris-Gbandi_GWA	player_Chris-Gbandi	player_GWA
player_Chris-Gbandi_HmA	player_Chris-Gbandi	player_HmA
player_Chris-Gbandi_RdA	player_Chris-Gbandi	player_RdA
player_Chris-Gbandi_A.90min	player_Chris-Gbandi	player_A.90min
player_Joshua-Gros_Club	player_Joshua-Gros	player_Club
player_Joshua-Gros_POS	player_Joshua-Gros	player_POS
player_Joshua-Gros_GP	player_Joshua-Gros	player_GP
player_Joshua-Gros_GS	player_Joshua-Gros	player_GS
player_Joshua-Gros_A	player_Joshua-Gros	player_A
player_Joshua-Gros_GWA	player_Joshua-Gros	player_GWA
player_Joshua-Gros_HmA	player_Joshua-Gros	player_HmA
player_Joshua-Gros_RdA	player_Joshua-Gros	player_RdA
player_Joshua-Gros_A.90min	player_Joshua-Gros	player_A.90min
player_Chris-Wingert_Club	player_Chris-Wingert	player_Club
player_Chris-Wingert_POS	player_Chris-Wingert	player_POS
player_Chris-Wingert_GP	player_Chris-Wingert	player_GP
player_Chris-Wingert_GS	player_Chris-Wingert	player_GS
player_Chris-Wingert_A	player_Chris-Wingert	player_A
player_Chris-Wingert_GWA	player_Chris-Wingert	player_GWA
player_Chris-Wingert_HmA	player_Chris-Wingert	player_HmA
player_Chris-Wingert_RdA	player_Chris-Wingert	player_RdA
player_Chris-Wingert_A.90min	player_Chris-Wingert	player_A.90min
player_Chris-Leitch_Club	player_Chris-Leitch	player_Club
player_Chris-Leitch_POS	player_Chris-Leitch	player_POS
player_Chris-Leitch_GP	player_Chris-Leitch	player_GP
player_Chris-Leitch_GS	player_Chris-Leitch	player_GS
player_Chris-Leitch_A	player_Chris-Leitch	player_A
player_Chris-Leitch_GWA	player_Chris-Leitch	player_GWA
player_Chris-Leitch_HmA	player_Chris-Leitch	player_HmA
player_Chris-Leitch_RdA	player_Chris-Leitch	player_RdA
player_Chris-Leitch_A.90min	player_Chris-Leitch	player_A.90min
player_Jose-Burciaga-Jr._Club	player_Jose-Burciaga-Jr.	player_Club
player_Jose-Burciaga-Jr._POS	player_Jose-Burciaga-Jr.	player_POS
player_Jose-Burciaga-Jr._GP	player_Jose-Burciaga-Jr.	player_GP
player_Jose-Burciaga-Jr._GS	player_Jose-Burciaga-Jr.	player_GS
player_Jose-Burciaga-Jr._A	player_Jose-Burciaga-Jr.	player_A
player_Jose-Burciaga-Jr._GWA	player_Jose-Burciaga-Jr.	player_GWA
player_Jose-Burciaga-Jr._HmA	player_Jose-Burciaga-Jr.	player_HmA
player_Jose-Burciaga-Jr._RdA	player_Jose-Burciaga-Jr.	player_RdA
player_Jose-Burciaga-Jr._A.90min	player_Jose-Burciaga-Jr.	player_A.90min
player_Tim-Ward_Club	player_Tim-Ward	player_Club
player_Tim-Ward_POS	player_Tim-Ward	player_POS
player_Tim-Ward_GP	player_Tim-Ward	player_GP
player_Tim-Ward_GS	player_Tim-Ward	player_GS
player_Tim-Ward_A	player_Tim-Ward	player_A
player_Tim-Ward_GWA	player_Tim-Ward	player_GWA
player_Tim-Ward_HmA	player_Tim-Ward	player_HmA
player_Tim-Ward_RdA	player_Tim-Ward	player_RdA
player_Tim-Ward_A.90min	player_Tim-Ward	player_A.90min
player_James-Riley_Club	player_James-Riley	player_Club
player_James-Riley_POS	player_James-Riley	player_POS
player_James-Riley_GP	player_James-Riley	player_GP
player_James-Riley_GS	player_James-Riley	player_GS
player_James-Riley_A	player_James-Riley	player_A
player_James-Riley_GWA	player_James-Riley	player_GWA
player_James-Riley_HmA	player_James-Riley	player_HmA
player_James-Riley_RdA	player_James-Riley	player_RdA
player_James-Riley_A.90min	player_James-Riley	player_A.90min
player_Jim-Curtin_Club	player_Jim-Curtin	player_Club
player_Jim-Curtin_POS	player_Jim-Curtin	player_POS
player_Jim-Curtin_GP	player_Jim-Curtin	player_GP
player_Jim-Curtin_GS	player_Jim-Curtin	player_GS
player_Jim-Curtin_A	player_Jim-Curtin	player_A
player_Jim-Curtin_GWA	player_Jim-Curtin	player_GWA
player_Jim-Curtin_HmA	player_Jim-Curtin	player_HmA
player_Jim-Curtin_RdA	player_Jim-Curtin	player_RdA
player_Jim-Curtin_A.90min	player_Jim-Curtin	player_A.90min
player_John-Wilson_Club	player_John-Wilson	player_Club
player_John-Wilson_POS	player_John-Wilson	player_POS
player_John-Wilson_GP	player_John-Wilson	player_GP
player_John-Wilson_GS	player_John-Wilson	player_GS
player_John-Wilson_A	player_John-Wilson	player_A
player_John-Wilson_GWA	player_John-Wilson	player_GWA
player_John-Wilson_HmA	player_John-Wilson	player_HmA
player_John-Wilson_RdA	player_John-Wilson	player_RdA
player_John-Wilson_A.90min	player_John-Wilson	player_A.90min
player_David-Wagenfuhr_Club	player_David-Wagenfuhr	player_Club
player_David-Wagenfuhr_POS	player_David-Wagenfuhr	player_POS
player_David-Wagenfuhr_GP	player_David-Wagenfuhr	player_GP
player_David-Wagenfuhr_GS	player_David-Wagenfuhr	player_GS
player_David-Wagenfuhr_A	player_David-Wagenfuhr	player_A
player_David-Wagenfuhr_GWA	player_David-Wagenfuhr	player_GWA
player_David-Wagenfuhr_HmA	player_David-Wagenfuhr	player_HmA
player_David-Wagenfuhr_RdA	player_David-Wagenfuhr	player_RdA
player_David-Wagenfuhr_A.90min	player_David-Wagenfuhr	player_A.90min
player_Gonzalo-Segares_Club	player_Gonzalo-Segares	player_Club
player_Gonzalo-Segares_POS	player_Gonzalo-Segares	player_POS
player_Gonzalo-Segares_GP	player_Gonzalo-Segares	player_GP
player_Gonzalo-Segares_GS	player_Gonzalo-Segares	player_GS
player_Gonzalo-Segares_A	player_Gonzalo-Segares	player_A
player_Gonzalo-Segares_GWA	player_Gonzalo-Segares	player_GWA
player_Gonzalo-Segares_HmA	player_Gonzalo-Segares	player_HmA
player_Gonzalo-Segares_RdA	player_Gonzalo-Segares	player_RdA
player_Gonzalo-Segares_A.90min	player_Gonzalo-Segares	player_A.90min
player_Jimmy-Conrad_Club	player_Jimmy-Conrad	player_Club
player_Jimmy-Conrad_POS	player_Jimmy-Conrad	player_POS
player_Jimmy-Conrad_GP	player_Jimmy-Conrad	player_GP
player_Jimmy-Conrad_GS	player_Jimmy-Conrad	player_GS
player_Jimmy-Conrad_A	player_Jimmy-Conrad	player_A
player_Jimmy-Conrad_GWA	player_Jimmy-Conrad	player_GWA
player_Jimmy-Conrad_HmA	player_Jimmy-Conrad	player_HmA
player_Jimmy-Conrad_RdA	player_Jimmy-Conrad	player_RdA
player_Jimmy-Conrad_A.90min	player_Jimmy-Conrad	player_A.90min
player_Seth-Stammler_Club	player_Seth-Stammler	player_Club
player_Seth-Stammler_POS	player_Seth-Stammler	player_POS
player_Seth-Stammler_GP	player_Seth-Stammler	player_GP
player_Seth-Stammler_GS	player_Seth-Stammler	player_GS
player_Seth-Stammler_A	player_Seth-Stammler	player_A
player_Seth-Stammler_GWA	player_Seth-Stammler	player_GWA
player_Seth-Stammler_HmA	player_Seth-Stammler	player_HmA
player_Seth-Stammler_RdA	player_Seth-Stammler	player_RdA
player_Seth-Stammler_A.90min	player_Seth-Stammler	player_A.90min
player_Brian-Mullan_Club	player_Brian-Mullan	player_Club
player_Brian-Mullan_POS	player_Brian-Mullan	player_POS
player_Brian-Mullan_GP	player_Brian-Mullan	player_GP
player_Brian-Mullan_GS	player_Brian-Mullan	player_GS
player_Brian-Mullan_A	player_Brian-Mullan	player_A
player_Brian-Mullan_GWA	player_Brian-Mullan	player_GWA
player_Brian-Mullan_HmA	player_Brian-Mullan	player_HmA
player_Brian-Mullan_RdA	player_Brian-Mullan	player_RdA
player_Brian-Mullan_A.90min	player_Brian-Mullan	player_A.90min
player_Eddie-Robinson_Club	player_Eddie-Robinson	player_Club
player_Eddie-Robinson_POS	player_Eddie-Robinson	player_POS
player_Eddie-Robinson_GP	player_Eddie-Robinson	player_GP
player_Eddie-Robinson_GS	player_Eddie-Robinson	player_GS
player_Eddie-Robinson_A	player_Eddie-Robinson	player_A
player_Eddie-Robinson_GWA	player_Eddie-Robinson	player_GWA
player_Eddie-Robinson_HmA	player_Eddie-Robinson	player_HmA
player_Eddie-Robinson_RdA	player_Eddie-Robinson	player_RdA
player_Eddie-Robinson_A.90min	player_Eddie-Robinson	player_A.90min
player_Marvell-Wynne_Club	player_Marvell-Wynne	player_Club
player_Marvell-Wynne_POS	player_Marvell-Wynne	player_POS
player_Marvell-Wynne_GP	player_Marvell-Wynne	player_GP
player_Marvell-Wynne_GS	player_Marvell-Wynne	player_GS
player_Marvell-Wynne_A	player_Marvell-Wynne	player_A
player_Marvell-Wynne_GWA	player_Marvell-Wynne	player_GWA
player_Marvell-Wynne_HmA	player_Marvell-Wynne	player_HmA
player_Marvell-Wynne_RdA	player_Marvell-Wynne	player_RdA
player_Marvell-Wynne_A.90min	player_Marvell-Wynne	player_A.90min
player_Wade-Barrett_Club	player_Wade-Barrett	player_Club
player_Wade-Barrett_POS	player_Wade-Barrett	player_POS
player_Wade-Barrett_GP	player_Wade-Barrett	player_GP
player_Wade-Barrett_GS	player_Wade-Barrett	player_GS
player_Wade-Barrett_A	player_Wade-Barrett	player_A
player_Wade-Barrett_GWA	player_Wade-Barrett	player_GWA
player_Wade-Barrett_HmA	player_Wade-Barrett	player_HmA
player_Wade-Barrett_RdA	player_Wade-Barrett	player_RdA
player_Wade-Barrett_A.90min	player_Wade-Barrett	player_A.90min
player_Tony-Lochhead_Club	player_Tony-Lochhead	player_Club
player_Tony-Lochhead_POS	player_Tony-Lochhead	player_POS
player_Tony-Lochhead_GP	player_Tony-Lochhead	player_GP
player_Tony-Lochhead_GS	player_Tony-Lochhead	player_GS
player_Tony-Lochhead_A	player_Tony-Lochhead	player_A
player_Tony-Lochhead_GWA	player_Tony-Lochhead	player_GWA
player_Tony-Lochhead_HmA	player_Tony-Lochhead	player_HmA
player_Tony-Lochhead_RdA	player_Tony-Lochhead	player_RdA
player_Tony-Lochhead_A.90min	player_Tony-Lochhead	player_A.90min
player_Danny-O'Rourke_Club	player_Danny-O'Rourke	player_Club
player_Danny-O'Rourke_POS	player_Danny-O'Rourke	player_POS
player_Danny-O'Rourke_GP	player_Danny-O'Rourke	player_GP
player_Danny-O'Rourke_GS	player_Danny-O'Rourke	player_GS
player_Danny-O'Rourke_A	player_Danny-O'Rourke	player_A
player_Danny-O'Rourke_GWA	player_Danny-O'Rourke	player_GWA
player_Danny-O'Rourke_HmA	player_Danny-O'Rourke	player_HmA
player_Danny-O'Rourke_RdA	player_Danny-O'Rourke	player_RdA
player_Danny-O'Rourke_A.90min	player_Danny-O'Rourke	player_A.90min
player_Greg-Vanney_Club	player_Greg-Vanney	player_Club
player_Greg-Vanney_POS	player_Greg-Vanney	player_POS
player_Greg-Vanney_GP	player_Greg-Vanney	player_GP
player_Greg-Vanney_GS	player_Greg-Vanney	player_GS
player_Greg-Vanney_A	player_Greg-Vanney	player_A
player_Greg-Vanney_GWA	player_Greg-Vanney	player_GWA
player_Greg-Vanney_HmA	player_Greg-Vanney	player_HmA
player_Greg-Vanney_RdA	player_Greg-Vanney	player_RdA
player_Greg-Vanney_A.90min	player_Greg-Vanney	player_A.90min
player_Facundo-Erpen_Club	player_Facundo-Erpen	player_Club
player_Facundo-Erpen_POS	player_Facundo-Erpen	player_POS
player_Facundo-Erpen_GP	player_Facundo-Erpen	player_GP
player_Facundo-Erpen_GS	player_Facundo-Erpen	player_GS
player_Facundo-Erpen_A	player_Facundo-Erpen	player_A
player_Facundo-Erpen_GWA	player_Facundo-Erpen	player_GWA
player_Facundo-Erpen_HmA	player_Facundo-Erpen	player_HmA
player_Facundo-Erpen_RdA	player_Facundo-Erpen	player_RdA
player_Facundo-Erpen_A.90min	player_Facundo-Erpen	player_A.90min
player_Michael-Harrington_Club	player_Michael-Harrington	player_Club
player_Michael-Harrington_POS	player_Michael-Harrington	player_POS
player_Michael-Harrington_GP	player_Michael-Harrington	player_GP
player_Michael-Harrington_GS	player_Michael-Harrington	player_GS
player_Michael-Harrington_A	player_Michael-Harrington	player_A
player_Michael-Harrington_GWA	player_Michael-Harrington	player_GWA
player_Michael-Harrington_HmA	player_Michael-Harrington	player_HmA
player_Michael-Harrington_RdA	player_Michael-Harrington	player_RdA
player_Michael-Harrington_A.90min	player_Michael-Harrington	player_A.90min
player_Marc-Burch_Club	player_Marc-Burch	player_Club
player_Marc-Burch_POS	player_Marc-Burch	player_POS
player_Marc-Burch_GP	player_Marc-Burch	player_GP
player_Marc-Burch_GS	player_Marc-Burch	player_GS
player_Marc-Burch_A	player_Marc-Burch	player_A
player_Marc-Burch_GWA	player_Marc-Burch	player_GWA
player_Marc-Burch_HmA	player_Marc-Burch	player_HmA
player_Marc-Burch_RdA	player_Marc-Burch	player_RdA
player_Marc-Burch_A.90min	player_Marc-Burch	player_A.90min
player_Chris-Pozniak_Club	player_Chris-Pozniak	player_Club
player_Chris-Pozniak_POS	player_Chris-Pozniak	player_POS
player_Chris-Pozniak_GP	player_Chris-Pozniak	player_GP
player_Chris-Pozniak_GS	player_Chris-Pozniak	player_GS
player_Chris-Pozniak_A	player_Chris-Pozniak	player_A
player_Chris-Pozniak_GWA	player_Chris-Pozniak	player_GWA
player_Chris-Pozniak_HmA	player_Chris-Pozniak	player_HmA
player_Chris-Pozniak_RdA	player_Chris-Pozniak	player_RdA
player_Chris-Pozniak_A.90min	player_Chris-Pozniak	player_A.90min
player_Pablo-Ricchetti_Club	player_Pablo-Ricchetti	player_Club
player_Pablo-Ricchetti_POS	player_Pablo-Ricchetti	player_POS
player_Pablo-Ricchetti_GP	player_Pablo-Ricchetti	player_GP
player_Pablo-Ricchetti_GS	player_Pablo-Ricchetti	player_GS
player_Pablo-Ricchetti_A	player_Pablo-Ricchetti	player_A
player_Pablo-Ricchetti_GWA	player_Pablo-Ricchetti	player_GWA
player_Pablo-Ricchetti_HmA	player_Pablo-Ricchetti	player_HmA
player_Pablo-Ricchetti_RdA	player_Pablo-Ricchetti	player_RdA
player_Pablo-Ricchetti_A.90min	player_Pablo-Ricchetti	player_A.90min
player_Ryan-Raybould_Club	player_Ryan-Raybould	player_Club
player_Ryan-Raybould_POS	player_Ryan-Raybould	player_POS
player_Ryan-Raybould_GP	player_Ryan-Raybould	player_GP
player_Ryan-Raybould_GS	player_Ryan-Raybould	player_GS
player_Ryan-Raybould_A	player_Ryan-Raybould	player_A
player_Ryan-Raybould_GWA	player_Ryan-Raybould	player_GWA
player_Ryan-Raybould_HmA	player_Ryan-Raybould	player_HmA
player_Ryan-Raybould_RdA	player_Ryan-Raybould	player_RdA
player_Ryan-Raybould_A.90min	player_Ryan-Raybould	player_A.90min
player_Craig-Waibel_Club	player_Craig-Waibel	player_Club
player_Craig-Waibel_POS	player_Craig-Waibel	player_POS
player_Craig-Waibel_GP	player_Craig-Waibel	player_GP
player_Craig-Waibel_GS	player_Craig-Waibel	player_GS
player_Craig-Waibel_A	player_Craig-Waibel	player_A
player_Craig-Waibel_GWA	player_Craig-Waibel	player_GWA
player_Craig-Waibel_HmA	player_Craig-Waibel	player_HmA
player_Craig-Waibel_RdA	player_Craig-Waibel	player_RdA
player_Craig-Waibel_A.90min	player_Craig-Waibel	player_A.90min
player_Bobby-Boswell_Club	player_Bobby-Boswell	player_Club
player_Bobby-Boswell_POS	player_Bobby-Boswell	player_POS
player_Bobby-Boswell_GP	player_Bobby-Boswell	player_GP
player_Bobby-Boswell_GS	player_Bobby-Boswell	player_GS
player_Bobby-Boswell_A	player_Bobby-Boswell	player_A
player_Bobby-Boswell_GWA	player_Bobby-Boswell	player_GWA
player_Bobby-Boswell_HmA	player_Bobby-Boswell	player_HmA
player_Bobby-Boswell_RdA	player_Bobby-Boswell	player_RdA
player_Bobby-Boswell_A.90min	player_Bobby-Boswell	player_A.90min
