player_Paul-Wright_Club	player_Paul-Wright	player_Club
player_Paul-Wright_POS	player_Paul-Wright	player_POS
player_Paul-Wright_GP	player_Paul-Wright	player_GP
player_Paul-Wright_GS	player_Paul-Wright	player_GS
player_Paul-Wright_A	player_Paul-Wright	player_A
player_Paul-Wright_GWA	player_Paul-Wright	player_GWA
player_Paul-Wright_HmA	player_Paul-Wright	player_HmA
player_Paul-Wright_RdA	player_Paul-Wright	player_RdA
player_Paul-Wright_A.90min	player_Paul-Wright	player_A.90min
player_Jaime-Moreno_Club	player_Jaime-Moreno	player_Club
player_Jaime-Moreno_POS	player_Jaime-Moreno	player_POS
player_Jaime-Moreno_GP	player_Jaime-Moreno	player_GP
player_Jaime-Moreno_GS	player_Jaime-Moreno	player_GS
player_Jaime-Moreno_A	player_Jaime-Moreno	player_A
player_Jaime-Moreno_GWA	player_Jaime-Moreno	player_GWA
player_Jaime-Moreno_HmA	player_Jaime-Moreno	player_HmA
player_Jaime-Moreno_RdA	player_Jaime-Moreno	player_RdA
player_Jaime-Moreno_A.90min	player_Jaime-Moreno	player_A.90min
player_Kris-Kelderman_Club	player_Kris-Kelderman	player_Club
player_Kris-Kelderman_POS	player_Kris-Kelderman	player_POS
player_Kris-Kelderman_GP	player_Kris-Kelderman	player_GP
player_Kris-Kelderman_GS	player_Kris-Kelderman	player_GS
player_Kris-Kelderman_A	player_Kris-Kelderman	player_A
player_Kris-Kelderman_GWA	player_Kris-Kelderman	player_GWA
player_Kris-Kelderman_HmA	player_Kris-Kelderman	player_HmA
player_Kris-Kelderman_RdA	player_Kris-Kelderman	player_RdA
player_Kris-Kelderman_A.90min	player_Kris-Kelderman	player_A.90min
player_Ruben-Hernandez_Club	player_Ruben-Hernandez	player_Club
player_Ruben-Hernandez_POS	player_Ruben-Hernandez	player_POS
player_Ruben-Hernandez_GP	player_Ruben-Hernandez	player_GP
player_Ruben-Hernandez_GS	player_Ruben-Hernandez	player_GS
player_Ruben-Hernandez_A	player_Ruben-Hernandez	player_A
player_Ruben-Hernandez_GWA	player_Ruben-Hernandez	player_GWA
player_Ruben-Hernandez_HmA	player_Ruben-Hernandez	player_HmA
player_Ruben-Hernandez_RdA	player_Ruben-Hernandez	player_RdA
player_Ruben-Hernandez_A.90min	player_Ruben-Hernandez	player_A.90min
player_Rob-Johnson_Club	player_Rob-Johnson	player_Club
player_Rob-Johnson_POS	player_Rob-Johnson	player_POS
player_Rob-Johnson_GP	player_Rob-Johnson	player_GP
player_Rob-Johnson_GS	player_Rob-Johnson	player_GS
player_Rob-Johnson_A	player_Rob-Johnson	player_A
player_Rob-Johnson_GWA	player_Rob-Johnson	player_GWA
player_Rob-Johnson_HmA	player_Rob-Johnson	player_HmA
player_Rob-Johnson_RdA	player_Rob-Johnson	player_RdA
player_Rob-Johnson_A.90min	player_Rob-Johnson	player_A.90min
player_Pete-Marino_Club	player_Pete-Marino	player_Club
player_Pete-Marino_POS	player_Pete-Marino	player_POS
player_Pete-Marino_GP	player_Pete-Marino	player_GP
player_Pete-Marino_GS	player_Pete-Marino	player_GS
player_Pete-Marino_A	player_Pete-Marino	player_A
player_Pete-Marino_GWA	player_Pete-Marino	player_GWA
player_Pete-Marino_HmA	player_Pete-Marino	player_HmA
player_Pete-Marino_RdA	player_Pete-Marino	player_RdA
player_Pete-Marino_A.90min	player_Pete-Marino	player_A.90min
player_Jesse-Marsch_Club	player_Jesse-Marsch	player_Club
player_Jesse-Marsch_POS	player_Jesse-Marsch	player_POS
player_Jesse-Marsch_GP	player_Jesse-Marsch	player_GP
player_Jesse-Marsch_GS	player_Jesse-Marsch	player_GS
player_Jesse-Marsch_A	player_Jesse-Marsch	player_A
player_Jesse-Marsch_GWA	player_Jesse-Marsch	player_GWA
player_Jesse-Marsch_HmA	player_Jesse-Marsch	player_HmA
player_Jesse-Marsch_RdA	player_Jesse-Marsch	player_RdA
player_Jesse-Marsch_A.90min	player_Jesse-Marsch	player_A.90min
player_Temoc-Suarez_Club	player_Temoc-Suarez	player_Club
player_Temoc-Suarez_POS	player_Temoc-Suarez	player_POS
player_Temoc-Suarez_GP	player_Temoc-Suarez	player_GP
player_Temoc-Suarez_GS	player_Temoc-Suarez	player_GS
player_Temoc-Suarez_A	player_Temoc-Suarez	player_A
player_Temoc-Suarez_GWA	player_Temoc-Suarez	player_GWA
player_Temoc-Suarez_HmA	player_Temoc-Suarez	player_HmA
player_Temoc-Suarez_RdA	player_Temoc-Suarez	player_RdA
player_Temoc-Suarez_A.90min	player_Temoc-Suarez	player_A.90min
player_Alan-Prampin_Club	player_Alan-Prampin	player_Club
player_Alan-Prampin_POS	player_Alan-Prampin	player_POS
player_Alan-Prampin_GP	player_Alan-Prampin	player_GP
player_Alan-Prampin_GS	player_Alan-Prampin	player_GS
player_Alan-Prampin_A	player_Alan-Prampin	player_A
player_Alan-Prampin_GWA	player_Alan-Prampin	player_GWA
player_Alan-Prampin_HmA	player_Alan-Prampin	player_HmA
player_Alan-Prampin_RdA	player_Alan-Prampin	player_RdA
player_Alan-Prampin_A.90min	player_Alan-Prampin	player_A.90min
player_Andy-Williams_Club	player_Andy-Williams	player_Club
player_Andy-Williams_POS	player_Andy-Williams	player_POS
player_Andy-Williams_GP	player_Andy-Williams	player_GP
player_Andy-Williams_GS	player_Andy-Williams	player_GS
player_Andy-Williams_A	player_Andy-Williams	player_A
player_Andy-Williams_GWA	player_Andy-Williams	player_GWA
player_Andy-Williams_HmA	player_Andy-Williams	player_HmA
player_Andy-Williams_RdA	player_Andy-Williams	player_RdA
player_Andy-Williams_A.90min	player_Andy-Williams	player_A.90min
player_Brian-Maisonneuve_Club	player_Brian-Maisonneuve	player_Club
player_Brian-Maisonneuve_POS	player_Brian-Maisonneuve	player_POS
player_Brian-Maisonneuve_GP	player_Brian-Maisonneuve	player_GP
player_Brian-Maisonneuve_GS	player_Brian-Maisonneuve	player_GS
player_Brian-Maisonneuve_A	player_Brian-Maisonneuve	player_A
player_Brian-Maisonneuve_GWA	player_Brian-Maisonneuve	player_GWA
player_Brian-Maisonneuve_HmA	player_Brian-Maisonneuve	player_HmA
player_Brian-Maisonneuve_RdA	player_Brian-Maisonneuve	player_RdA
player_Brian-Maisonneuve_A.90min	player_Brian-Maisonneuve	player_A.90min
player_Paul-Young_Club	player_Paul-Young	player_Club
player_Paul-Young_POS	player_Paul-Young	player_POS
player_Paul-Young_GP	player_Paul-Young	player_GP
player_Paul-Young_GS	player_Paul-Young	player_GS
player_Paul-Young_A	player_Paul-Young	player_A
player_Paul-Young_GWA	player_Paul-Young	player_GWA
player_Paul-Young_HmA	player_Paul-Young	player_HmA
player_Paul-Young_RdA	player_Paul-Young	player_RdA
player_Paul-Young_A.90min	player_Paul-Young	player_A.90min
player_Dominic-Kinnear_Club	player_Dominic-Kinnear	player_Club
player_Dominic-Kinnear_POS	player_Dominic-Kinnear	player_POS
player_Dominic-Kinnear_GP	player_Dominic-Kinnear	player_GP
player_Dominic-Kinnear_GS	player_Dominic-Kinnear	player_GS
player_Dominic-Kinnear_A	player_Dominic-Kinnear	player_A
player_Dominic-Kinnear_GWA	player_Dominic-Kinnear	player_GWA
player_Dominic-Kinnear_HmA	player_Dominic-Kinnear	player_HmA
player_Dominic-Kinnear_RdA	player_Dominic-Kinnear	player_RdA
player_Dominic-Kinnear_A.90min	player_Dominic-Kinnear	player_A.90min
player_Nelson-Vargas_Club	player_Nelson-Vargas	player_Club
player_Nelson-Vargas_POS	player_Nelson-Vargas	player_POS
player_Nelson-Vargas_GP	player_Nelson-Vargas	player_GP
player_Nelson-Vargas_GS	player_Nelson-Vargas	player_GS
player_Nelson-Vargas_A	player_Nelson-Vargas	player_A
player_Nelson-Vargas_GWA	player_Nelson-Vargas	player_GWA
player_Nelson-Vargas_HmA	player_Nelson-Vargas	player_HmA
player_Nelson-Vargas_RdA	player_Nelson-Vargas	player_RdA
player_Nelson-Vargas_A.90min	player_Nelson-Vargas	player_A.90min
player_Paul-Keegan_Club	player_Paul-Keegan	player_Club
player_Paul-Keegan_POS	player_Paul-Keegan	player_POS
player_Paul-Keegan_GP	player_Paul-Keegan	player_GP
player_Paul-Keegan_GS	player_Paul-Keegan	player_GS
player_Paul-Keegan_A	player_Paul-Keegan	player_A
player_Paul-Keegan_GWA	player_Paul-Keegan	player_GWA
player_Paul-Keegan_HmA	player_Paul-Keegan	player_HmA
player_Paul-Keegan_RdA	player_Paul-Keegan	player_RdA
player_Paul-Keegan_A.90min	player_Paul-Keegan	player_A.90min
player_Marcelo-Carrera_Club	player_Marcelo-Carrera	player_Club
player_Marcelo-Carrera_POS	player_Marcelo-Carrera	player_POS
player_Marcelo-Carrera_GP	player_Marcelo-Carrera	player_GP
player_Marcelo-Carrera_GS	player_Marcelo-Carrera	player_GS
player_Marcelo-Carrera_A	player_Marcelo-Carrera	player_A
player_Marcelo-Carrera_GWA	player_Marcelo-Carrera	player_GWA
player_Marcelo-Carrera_HmA	player_Marcelo-Carrera	player_HmA
player_Marcelo-Carrera_RdA	player_Marcelo-Carrera	player_RdA
player_Marcelo-Carrera_A.90min	player_Marcelo-Carrera	player_A.90min
player_Josh-Wolff_Club	player_Josh-Wolff	player_Club
player_Josh-Wolff_POS	player_Josh-Wolff	player_POS
player_Josh-Wolff_GP	player_Josh-Wolff	player_GP
player_Josh-Wolff_GS	player_Josh-Wolff	player_GS
player_Josh-Wolff_A	player_Josh-Wolff	player_A
player_Josh-Wolff_GWA	player_Josh-Wolff	player_GWA
player_Josh-Wolff_HmA	player_Josh-Wolff	player_HmA
player_Josh-Wolff_RdA	player_Josh-Wolff	player_RdA
player_Josh-Wolff_A.90min	player_Josh-Wolff	player_A.90min
player_Dan-Stebbins_Club	player_Dan-Stebbins	player_Club
player_Dan-Stebbins_POS	player_Dan-Stebbins	player_POS
player_Dan-Stebbins_GP	player_Dan-Stebbins	player_GP
player_Dan-Stebbins_GS	player_Dan-Stebbins	player_GS
player_Dan-Stebbins_A	player_Dan-Stebbins	player_A
player_Dan-Stebbins_GWA	player_Dan-Stebbins	player_GWA
player_Dan-Stebbins_HmA	player_Dan-Stebbins	player_HmA
player_Dan-Stebbins_RdA	player_Dan-Stebbins	player_RdA
player_Dan-Stebbins_A.90min	player_Dan-Stebbins	player_A.90min
player_Petter-Villegas_Club	player_Petter-Villegas	player_Club
player_Petter-Villegas_POS	player_Petter-Villegas	player_POS
player_Petter-Villegas_GP	player_Petter-Villegas	player_GP
player_Petter-Villegas_GS	player_Petter-Villegas	player_GS
player_Petter-Villegas_A	player_Petter-Villegas	player_A
player_Petter-Villegas_GWA	player_Petter-Villegas	player_GWA
player_Petter-Villegas_HmA	player_Petter-Villegas	player_HmA
player_Petter-Villegas_RdA	player_Petter-Villegas	player_RdA
player_Petter-Villegas_A.90min	player_Petter-Villegas	player_A.90min
player_Manny-Lagos_Club	player_Manny-Lagos	player_Club
player_Manny-Lagos_POS	player_Manny-Lagos	player_POS
player_Manny-Lagos_GP	player_Manny-Lagos	player_GP
player_Manny-Lagos_GS	player_Manny-Lagos	player_GS
player_Manny-Lagos_A	player_Manny-Lagos	player_A
player_Manny-Lagos_GWA	player_Manny-Lagos	player_GWA
player_Manny-Lagos_HmA	player_Manny-Lagos	player_HmA
player_Manny-Lagos_RdA	player_Manny-Lagos	player_RdA
player_Manny-Lagos_A.90min	player_Manny-Lagos	player_A.90min
player_Paul-Dougherty_Club	player_Paul-Dougherty	player_Club
player_Paul-Dougherty_POS	player_Paul-Dougherty	player_POS
player_Paul-Dougherty_GP	player_Paul-Dougherty	player_GP
player_Paul-Dougherty_GS	player_Paul-Dougherty	player_GS
player_Paul-Dougherty_A	player_Paul-Dougherty	player_A
player_Paul-Dougherty_GWA	player_Paul-Dougherty	player_GWA
player_Paul-Dougherty_HmA	player_Paul-Dougherty	player_HmA
player_Paul-Dougherty_RdA	player_Paul-Dougherty	player_RdA
player_Paul-Dougherty_A.90min	player_Paul-Dougherty	player_A.90min
player_Dante-Washington_Club	player_Dante-Washington	player_Club
player_Dante-Washington_POS	player_Dante-Washington	player_POS
player_Dante-Washington_GP	player_Dante-Washington	player_GP
player_Dante-Washington_GS	player_Dante-Washington	player_GS
player_Dante-Washington_A	player_Dante-Washington	player_A
player_Dante-Washington_GWA	player_Dante-Washington	player_GWA
player_Dante-Washington_HmA	player_Dante-Washington	player_HmA
player_Dante-Washington_RdA	player_Dante-Washington	player_RdA
player_Dante-Washington_A.90min	player_Dante-Washington	player_A.90min
player_Tab-Ramos_Club	player_Tab-Ramos	player_Club
player_Tab-Ramos_POS	player_Tab-Ramos	player_POS
player_Tab-Ramos_GP	player_Tab-Ramos	player_GP
player_Tab-Ramos_GS	player_Tab-Ramos	player_GS
player_Tab-Ramos_A	player_Tab-Ramos	player_A
player_Tab-Ramos_GWA	player_Tab-Ramos	player_GWA
player_Tab-Ramos_HmA	player_Tab-Ramos	player_HmA
player_Tab-Ramos_RdA	player_Tab-Ramos	player_RdA
player_Tab-Ramos_A.90min	player_Tab-Ramos	player_A.90min
player_Maurizio-Rocha_Club	player_Maurizio-Rocha	player_Club
player_Maurizio-Rocha_POS	player_Maurizio-Rocha	player_POS
player_Maurizio-Rocha_GP	player_Maurizio-Rocha	player_GP
player_Maurizio-Rocha_GS	player_Maurizio-Rocha	player_GS
player_Maurizio-Rocha_A	player_Maurizio-Rocha	player_A
player_Maurizio-Rocha_GWA	player_Maurizio-Rocha	player_GWA
player_Maurizio-Rocha_HmA	player_Maurizio-Rocha	player_HmA
player_Maurizio-Rocha_RdA	player_Maurizio-Rocha	player_RdA
player_Maurizio-Rocha_A.90min	player_Maurizio-Rocha	player_A.90min
player_Johnny-Torres_Club	player_Johnny-Torres	player_Club
player_Johnny-Torres_POS	player_Johnny-Torres	player_POS
player_Johnny-Torres_GP	player_Johnny-Torres	player_GP
player_Johnny-Torres_GS	player_Johnny-Torres	player_GS
player_Johnny-Torres_A	player_Johnny-Torres	player_A
player_Johnny-Torres_GWA	player_Johnny-Torres	player_GWA
player_Johnny-Torres_HmA	player_Johnny-Torres	player_HmA
player_Johnny-Torres_RdA	player_Johnny-Torres	player_RdA
player_Johnny-Torres_A.90min	player_Johnny-Torres	player_A.90min
player_Hristo-Stoitchkov_Club	player_Hristo-Stoitchkov	player_Club
player_Hristo-Stoitchkov_POS	player_Hristo-Stoitchkov	player_POS
player_Hristo-Stoitchkov_GP	player_Hristo-Stoitchkov	player_GP
player_Hristo-Stoitchkov_GS	player_Hristo-Stoitchkov	player_GS
player_Hristo-Stoitchkov_A	player_Hristo-Stoitchkov	player_A
player_Hristo-Stoitchkov_GWA	player_Hristo-Stoitchkov	player_GWA
player_Hristo-Stoitchkov_HmA	player_Hristo-Stoitchkov	player_HmA
player_Hristo-Stoitchkov_RdA	player_Hristo-Stoitchkov	player_RdA
player_Hristo-Stoitchkov_A.90min	player_Hristo-Stoitchkov	player_A.90min
player_Paul-Broome_Club	player_Paul-Broome	player_Club
player_Paul-Broome_POS	player_Paul-Broome	player_POS
player_Paul-Broome_GP	player_Paul-Broome	player_GP
player_Paul-Broome_GS	player_Paul-Broome	player_GS
player_Paul-Broome_A	player_Paul-Broome	player_A
player_Paul-Broome_GWA	player_Paul-Broome	player_GWA
player_Paul-Broome_HmA	player_Paul-Broome	player_HmA
player_Paul-Broome_RdA	player_Paul-Broome	player_RdA
player_Paul-Broome_A.90min	player_Paul-Broome	player_A.90min
player_Antonio-Martinez_Club	player_Antonio-Martinez	player_Club
player_Antonio-Martinez_POS	player_Antonio-Martinez	player_POS
player_Antonio-Martinez_GP	player_Antonio-Martinez	player_GP
player_Antonio-Martinez_GS	player_Antonio-Martinez	player_GS
player_Antonio-Martinez_A	player_Antonio-Martinez	player_A
player_Antonio-Martinez_GWA	player_Antonio-Martinez	player_GWA
player_Antonio-Martinez_HmA	player_Antonio-Martinez	player_HmA
player_Antonio-Martinez_RdA	player_Antonio-Martinez	player_RdA
player_Antonio-Martinez_A.90min	player_Antonio-Martinez	player_A.90min
player_Jamar-Beasley_Club	player_Jamar-Beasley	player_Club
player_Jamar-Beasley_POS	player_Jamar-Beasley	player_POS
player_Jamar-Beasley_GP	player_Jamar-Beasley	player_GP
player_Jamar-Beasley_GS	player_Jamar-Beasley	player_GS
player_Jamar-Beasley_A	player_Jamar-Beasley	player_A
player_Jamar-Beasley_GWA	player_Jamar-Beasley	player_GWA
player_Jamar-Beasley_HmA	player_Jamar-Beasley	player_HmA
player_Jamar-Beasley_RdA	player_Jamar-Beasley	player_RdA
player_Jamar-Beasley_A.90min	player_Jamar-Beasley	player_A.90min
player_Aleksey-Korol_Club	player_Aleksey-Korol	player_Club
player_Aleksey-Korol_POS	player_Aleksey-Korol	player_POS
player_Aleksey-Korol_GP	player_Aleksey-Korol	player_GP
player_Aleksey-Korol_GS	player_Aleksey-Korol	player_GS
player_Aleksey-Korol_A	player_Aleksey-Korol	player_A
player_Aleksey-Korol_GWA	player_Aleksey-Korol	player_GWA
player_Aleksey-Korol_HmA	player_Aleksey-Korol	player_HmA
player_Aleksey-Korol_RdA	player_Aleksey-Korol	player_RdA
player_Aleksey-Korol_A.90min	player_Aleksey-Korol	player_A.90min
player_A.J.-Wood_Club	player_A.J.-Wood	player_Club
player_A.J.-Wood_POS	player_A.J.-Wood	player_POS
player_A.J.-Wood_GP	player_A.J.-Wood	player_GP
player_A.J.-Wood_GS	player_A.J.-Wood	player_GS
player_A.J.-Wood_A	player_A.J.-Wood	player_A
player_A.J.-Wood_GWA	player_A.J.-Wood	player_GWA
player_A.J.-Wood_HmA	player_A.J.-Wood	player_HmA
player_A.J.-Wood_RdA	player_A.J.-Wood	player_RdA
player_A.J.-Wood_A.90min	player_A.J.-Wood	player_A.90min
player_William-Sunsing_Club	player_William-Sunsing	player_Club
player_William-Sunsing_POS	player_William-Sunsing	player_POS
player_William-Sunsing_GP	player_William-Sunsing	player_GP
player_William-Sunsing_GS	player_William-Sunsing	player_GS
player_William-Sunsing_A	player_William-Sunsing	player_A
player_William-Sunsing_GWA	player_William-Sunsing	player_GWA
player_William-Sunsing_HmA	player_William-Sunsing	player_HmA
player_William-Sunsing_RdA	player_William-Sunsing	player_RdA
player_William-Sunsing_A.90min	player_William-Sunsing	player_A.90min
player_Bobby-Rhine_Club	player_Bobby-Rhine	player_Club
player_Bobby-Rhine_POS	player_Bobby-Rhine	player_POS
player_Bobby-Rhine_GP	player_Bobby-Rhine	player_GP
player_Bobby-Rhine_GS	player_Bobby-Rhine	player_GS
player_Bobby-Rhine_A	player_Bobby-Rhine	player_A
player_Bobby-Rhine_GWA	player_Bobby-Rhine	player_GWA
player_Bobby-Rhine_HmA	player_Bobby-Rhine	player_HmA
player_Bobby-Rhine_RdA	player_Bobby-Rhine	player_RdA
player_Bobby-Rhine_A.90min	player_Bobby-Rhine	player_A.90min
player_Bobby-Convey_Club	player_Bobby-Convey	player_Club
player_Bobby-Convey_POS	player_Bobby-Convey	player_POS
player_Bobby-Convey_GP	player_Bobby-Convey	player_GP
player_Bobby-Convey_GS	player_Bobby-Convey	player_GS
player_Bobby-Convey_A	player_Bobby-Convey	player_A
player_Bobby-Convey_GWA	player_Bobby-Convey	player_GWA
player_Bobby-Convey_HmA	player_Bobby-Convey	player_HmA
player_Bobby-Convey_RdA	player_Bobby-Convey	player_RdA
player_Bobby-Convey_A.90min	player_Bobby-Convey	player_A.90min
player_Clint-Mathis_Club	player_Clint-Mathis	player_Club
player_Clint-Mathis_POS	player_Clint-Mathis	player_POS
player_Clint-Mathis_GP	player_Clint-Mathis	player_GP
player_Clint-Mathis_GS	player_Clint-Mathis	player_GS
player_Clint-Mathis_A	player_Clint-Mathis	player_A
player_Clint-Mathis_GWA	player_Clint-Mathis	player_GWA
player_Clint-Mathis_HmA	player_Clint-Mathis	player_HmA
player_Clint-Mathis_RdA	player_Clint-Mathis	player_RdA
player_Clint-Mathis_A.90min	player_Clint-Mathis	player_A.90min
player_Gary-Glasgow_Club	player_Gary-Glasgow	player_Club
player_Gary-Glasgow_POS	player_Gary-Glasgow	player_POS
player_Gary-Glasgow_GP	player_Gary-Glasgow	player_GP
player_Gary-Glasgow_GS	player_Gary-Glasgow	player_GS
player_Gary-Glasgow_A	player_Gary-Glasgow	player_A
player_Gary-Glasgow_GWA	player_Gary-Glasgow	player_GWA
player_Gary-Glasgow_HmA	player_Gary-Glasgow	player_HmA
player_Gary-Glasgow_RdA	player_Gary-Glasgow	player_RdA
player_Gary-Glasgow_A.90min	player_Gary-Glasgow	player_A.90min
player_Sergi-Daniv_Club	player_Sergi-Daniv	player_Club
player_Sergi-Daniv_POS	player_Sergi-Daniv	player_POS
player_Sergi-Daniv_GP	player_Sergi-Daniv	player_GP
player_Sergi-Daniv_GS	player_Sergi-Daniv	player_GS
player_Sergi-Daniv_A	player_Sergi-Daniv	player_A
player_Sergi-Daniv_GWA	player_Sergi-Daniv	player_GWA
player_Sergi-Daniv_HmA	player_Sergi-Daniv	player_HmA
player_Sergi-Daniv_RdA	player_Sergi-Daniv	player_RdA
player_Sergi-Daniv_A.90min	player_Sergi-Daniv	player_A.90min
player_Lazo-Alavanja_Club	player_Lazo-Alavanja	player_Club
player_Lazo-Alavanja_POS	player_Lazo-Alavanja	player_POS
player_Lazo-Alavanja_GP	player_Lazo-Alavanja	player_GP
player_Lazo-Alavanja_GS	player_Lazo-Alavanja	player_GS
player_Lazo-Alavanja_A	player_Lazo-Alavanja	player_A
player_Lazo-Alavanja_GWA	player_Lazo-Alavanja	player_GWA
player_Lazo-Alavanja_HmA	player_Lazo-Alavanja	player_HmA
player_Lazo-Alavanja_RdA	player_Lazo-Alavanja	player_RdA
player_Lazo-Alavanja_A.90min	player_Lazo-Alavanja	player_A.90min
player_Onandi-Lowe_Club	player_Onandi-Lowe	player_Club
player_Onandi-Lowe_POS	player_Onandi-Lowe	player_POS
player_Onandi-Lowe_GP	player_Onandi-Lowe	player_GP
player_Onandi-Lowe_GS	player_Onandi-Lowe	player_GS
player_Onandi-Lowe_A	player_Onandi-Lowe	player_A
player_Onandi-Lowe_GWA	player_Onandi-Lowe	player_GWA
player_Onandi-Lowe_HmA	player_Onandi-Lowe	player_HmA
player_Onandi-Lowe_RdA	player_Onandi-Lowe	player_RdA
player_Onandi-Lowe_A.90min	player_Onandi-Lowe	player_A.90min
player_Braeden-Cloutier_Club	player_Braeden-Cloutier	player_Club
player_Braeden-Cloutier_POS	player_Braeden-Cloutier	player_POS
player_Braeden-Cloutier_GP	player_Braeden-Cloutier	player_GP
player_Braeden-Cloutier_GS	player_Braeden-Cloutier	player_GS
player_Braeden-Cloutier_A	player_Braeden-Cloutier	player_A
player_Braeden-Cloutier_GWA	player_Braeden-Cloutier	player_GWA
player_Braeden-Cloutier_HmA	player_Braeden-Cloutier	player_HmA
player_Braeden-Cloutier_RdA	player_Braeden-Cloutier	player_RdA
player_Braeden-Cloutier_A.90min	player_Braeden-Cloutier	player_A.90min
player_Ronald-Cerritos_Club	player_Ronald-Cerritos	player_Club
player_Ronald-Cerritos_POS	player_Ronald-Cerritos	player_POS
player_Ronald-Cerritos_GP	player_Ronald-Cerritos	player_GP
player_Ronald-Cerritos_GS	player_Ronald-Cerritos	player_GS
player_Ronald-Cerritos_A	player_Ronald-Cerritos	player_A
player_Ronald-Cerritos_GWA	player_Ronald-Cerritos	player_GWA
player_Ronald-Cerritos_HmA	player_Ronald-Cerritos	player_HmA
player_Ronald-Cerritos_RdA	player_Ronald-Cerritos	player_RdA
player_Ronald-Cerritos_A.90min	player_Ronald-Cerritos	player_A.90min
player_Diego-Serna_Club	player_Diego-Serna	player_Club
player_Diego-Serna_POS	player_Diego-Serna	player_POS
player_Diego-Serna_GP	player_Diego-Serna	player_GP
player_Diego-Serna_GS	player_Diego-Serna	player_GS
player_Diego-Serna_A	player_Diego-Serna	player_A
player_Diego-Serna_GWA	player_Diego-Serna	player_GWA
player_Diego-Serna_HmA	player_Diego-Serna	player_HmA
player_Diego-Serna_RdA	player_Diego-Serna	player_RdA
player_Diego-Serna_A.90min	player_Diego-Serna	player_A.90min
player_Santino-Quaranta_Club	player_Santino-Quaranta	player_Club
player_Santino-Quaranta_POS	player_Santino-Quaranta	player_POS
player_Santino-Quaranta_GP	player_Santino-Quaranta	player_GP
player_Santino-Quaranta_GS	player_Santino-Quaranta	player_GS
player_Santino-Quaranta_A	player_Santino-Quaranta	player_A
player_Santino-Quaranta_GWA	player_Santino-Quaranta	player_GWA
player_Santino-Quaranta_HmA	player_Santino-Quaranta	player_HmA
player_Santino-Quaranta_RdA	player_Santino-Quaranta	player_RdA
player_Santino-Quaranta_A.90min	player_Santino-Quaranta	player_A.90min
player_Ian-Fuller_Club	player_Ian-Fuller	player_Club
player_Ian-Fuller_POS	player_Ian-Fuller	player_POS
player_Ian-Fuller_GP	player_Ian-Fuller	player_GP
player_Ian-Fuller_GS	player_Ian-Fuller	player_GS
player_Ian-Fuller_A	player_Ian-Fuller	player_A
player_Ian-Fuller_GWA	player_Ian-Fuller	player_GWA
player_Ian-Fuller_HmA	player_Ian-Fuller	player_HmA
player_Ian-Fuller_RdA	player_Ian-Fuller	player_RdA
player_Ian-Fuller_A.90min	player_Ian-Fuller	player_A.90min
player_Brad-Davis_Club	player_Brad-Davis	player_Club
player_Brad-Davis_POS	player_Brad-Davis	player_POS
player_Brad-Davis_GP	player_Brad-Davis	player_GP
player_Brad-Davis_GS	player_Brad-Davis	player_GS
player_Brad-Davis_A	player_Brad-Davis	player_A
player_Brad-Davis_GWA	player_Brad-Davis	player_GWA
player_Brad-Davis_HmA	player_Brad-Davis	player_HmA
player_Brad-Davis_RdA	player_Brad-Davis	player_RdA
player_Brad-Davis_A.90min	player_Brad-Davis	player_A.90min
player_Jose-Cancela_Club	player_Jose-Cancela	player_Club
player_Jose-Cancela_POS	player_Jose-Cancela	player_POS
player_Jose-Cancela_GP	player_Jose-Cancela	player_GP
player_Jose-Cancela_GS	player_Jose-Cancela	player_GS
player_Jose-Cancela_A	player_Jose-Cancela	player_A
player_Jose-Cancela_GWA	player_Jose-Cancela	player_GWA
player_Jose-Cancela_HmA	player_Jose-Cancela	player_HmA
player_Jose-Cancela_RdA	player_Jose-Cancela	player_RdA
player_Jose-Cancela_A.90min	player_Jose-Cancela	player_A.90min
player_Freddy-Garcia_Club	player_Freddy-Garcia	player_Club
player_Freddy-Garcia_POS	player_Freddy-Garcia	player_POS
player_Freddy-Garcia_GP	player_Freddy-Garcia	player_GP
player_Freddy-Garcia_GS	player_Freddy-Garcia	player_GS
player_Freddy-Garcia_A	player_Freddy-Garcia	player_A
player_Freddy-Garcia_GWA	player_Freddy-Garcia	player_GWA
player_Freddy-Garcia_HmA	player_Freddy-Garcia	player_HmA
player_Freddy-Garcia_RdA	player_Freddy-Garcia	player_RdA
player_Freddy-Garcia_A.90min	player_Freddy-Garcia	player_A.90min
player_Toni-Nhleko_Club	player_Toni-Nhleko	player_Club
player_Toni-Nhleko_POS	player_Toni-Nhleko	player_POS
player_Toni-Nhleko_GP	player_Toni-Nhleko	player_GP
player_Toni-Nhleko_GS	player_Toni-Nhleko	player_GS
player_Toni-Nhleko_A	player_Toni-Nhleko	player_A
player_Toni-Nhleko_GWA	player_Toni-Nhleko	player_GWA
player_Toni-Nhleko_HmA	player_Toni-Nhleko	player_HmA
player_Toni-Nhleko_RdA	player_Toni-Nhleko	player_RdA
player_Toni-Nhleko_A.90min	player_Toni-Nhleko	player_A.90min
player_Eliseo-Quintanilla_Club	player_Eliseo-Quintanilla	player_Club
player_Eliseo-Quintanilla_POS	player_Eliseo-Quintanilla	player_POS
player_Eliseo-Quintanilla_GP	player_Eliseo-Quintanilla	player_GP
player_Eliseo-Quintanilla_GS	player_Eliseo-Quintanilla	player_GS
player_Eliseo-Quintanilla_A	player_Eliseo-Quintanilla	player_A
player_Eliseo-Quintanilla_GWA	player_Eliseo-Quintanilla	player_GWA
player_Eliseo-Quintanilla_HmA	player_Eliseo-Quintanilla	player_HmA
player_Eliseo-Quintanilla_RdA	player_Eliseo-Quintanilla	player_RdA
player_Eliseo-Quintanilla_A.90min	player_Eliseo-Quintanilla	player_A.90min
player_Richie-Baker_Club	player_Richie-Baker	player_Club
player_Richie-Baker_POS	player_Richie-Baker	player_POS
player_Richie-Baker_GP	player_Richie-Baker	player_GP
player_Richie-Baker_GS	player_Richie-Baker	player_GS
player_Richie-Baker_A	player_Richie-Baker	player_A
player_Richie-Baker_GWA	player_Richie-Baker	player_GWA
player_Richie-Baker_HmA	player_Richie-Baker	player_HmA
player_Richie-Baker_RdA	player_Richie-Baker	player_RdA
player_Richie-Baker_A.90min	player_Richie-Baker	player_A.90min
player_Oscar-Pareja_Club	player_Oscar-Pareja	player_Club
player_Oscar-Pareja_POS	player_Oscar-Pareja	player_POS
player_Oscar-Pareja_GP	player_Oscar-Pareja	player_GP
player_Oscar-Pareja_GS	player_Oscar-Pareja	player_GS
player_Oscar-Pareja_A	player_Oscar-Pareja	player_A
player_Oscar-Pareja_GWA	player_Oscar-Pareja	player_GWA
player_Oscar-Pareja_HmA	player_Oscar-Pareja	player_HmA
player_Oscar-Pareja_RdA	player_Oscar-Pareja	player_RdA
player_Oscar-Pareja_A.90min	player_Oscar-Pareja	player_A.90min
player_Mark-Lisi_Club	player_Mark-Lisi	player_Club
player_Mark-Lisi_POS	player_Mark-Lisi	player_POS
player_Mark-Lisi_GP	player_Mark-Lisi	player_GP
player_Mark-Lisi_GS	player_Mark-Lisi	player_GS
player_Mark-Lisi_A	player_Mark-Lisi	player_A
player_Mark-Lisi_GWA	player_Mark-Lisi	player_GWA
player_Mark-Lisi_HmA	player_Mark-Lisi	player_HmA
player_Mark-Lisi_RdA	player_Mark-Lisi	player_RdA
player_Mark-Lisi_A.90min	player_Mark-Lisi	player_A.90min
player_Jamil-Walker_Club	player_Jamil-Walker	player_Club
player_Jamil-Walker_POS	player_Jamil-Walker	player_POS
player_Jamil-Walker_GP	player_Jamil-Walker	player_GP
player_Jamil-Walker_GS	player_Jamil-Walker	player_GS
player_Jamil-Walker_A	player_Jamil-Walker	player_A
player_Jamil-Walker_GWA	player_Jamil-Walker	player_GWA
player_Jamil-Walker_HmA	player_Jamil-Walker	player_HmA
player_Jamil-Walker_RdA	player_Jamil-Walker	player_RdA
player_Jamil-Walker_A.90min	player_Jamil-Walker	player_A.90min
player_Chad-Barrett_Club	player_Chad-Barrett	player_Club
player_Chad-Barrett_POS	player_Chad-Barrett	player_POS
player_Chad-Barrett_GP	player_Chad-Barrett	player_GP
player_Chad-Barrett_GS	player_Chad-Barrett	player_GS
player_Chad-Barrett_A	player_Chad-Barrett	player_A
player_Chad-Barrett_GWA	player_Chad-Barrett	player_GWA
player_Chad-Barrett_HmA	player_Chad-Barrett	player_HmA
player_Chad-Barrett_RdA	player_Chad-Barrett	player_RdA
player_Chad-Barrett_A.90min	player_Chad-Barrett	player_A.90min
player_Abbe-Ibrahim_Club	player_Abbe-Ibrahim	player_Club
player_Abbe-Ibrahim_POS	player_Abbe-Ibrahim	player_POS
player_Abbe-Ibrahim_GP	player_Abbe-Ibrahim	player_GP
player_Abbe-Ibrahim_GS	player_Abbe-Ibrahim	player_GS
player_Abbe-Ibrahim_A	player_Abbe-Ibrahim	player_A
player_Abbe-Ibrahim_GWA	player_Abbe-Ibrahim	player_GWA
player_Abbe-Ibrahim_HmA	player_Abbe-Ibrahim	player_HmA
player_Abbe-Ibrahim_RdA	player_Abbe-Ibrahim	player_RdA
player_Abbe-Ibrahim_A.90min	player_Abbe-Ibrahim	player_A.90min
player_David-Testo_Club	player_David-Testo	player_Club
player_David-Testo_POS	player_David-Testo	player_POS
player_David-Testo_GP	player_David-Testo	player_GP
player_David-Testo_GS	player_David-Testo	player_GS
player_David-Testo_A	player_David-Testo	player_A
player_David-Testo_GWA	player_David-Testo	player_GWA
player_David-Testo_HmA	player_David-Testo	player_HmA
player_David-Testo_RdA	player_David-Testo	player_RdA
player_David-Testo_A.90min	player_David-Testo	player_A.90min
player_Ramon-Nunez_Club	player_Ramon-Nunez	player_Club
player_Ramon-Nunez_POS	player_Ramon-Nunez	player_POS
player_Ramon-Nunez_GP	player_Ramon-Nunez	player_GP
player_Ramon-Nunez_GS	player_Ramon-Nunez	player_GS
player_Ramon-Nunez_A	player_Ramon-Nunez	player_A
player_Ramon-Nunez_GWA	player_Ramon-Nunez	player_GWA
player_Ramon-Nunez_HmA	player_Ramon-Nunez	player_HmA
player_Ramon-Nunez_RdA	player_Ramon-Nunez	player_RdA
player_Ramon-Nunez_A.90min	player_Ramon-Nunez	player_A.90min
player_Abe-Thompson_Club	player_Abe-Thompson	player_Club
player_Abe-Thompson_POS	player_Abe-Thompson	player_POS
player_Abe-Thompson_GP	player_Abe-Thompson	player_GP
player_Abe-Thompson_GS	player_Abe-Thompson	player_GS
player_Abe-Thompson_A	player_Abe-Thompson	player_A
player_Abe-Thompson_GWA	player_Abe-Thompson	player_GWA
player_Abe-Thompson_HmA	player_Abe-Thompson	player_HmA
player_Abe-Thompson_RdA	player_Abe-Thompson	player_RdA
player_Abe-Thompson_A.90min	player_Abe-Thompson	player_A.90min
player_Pat-Noonan_Club	player_Pat-Noonan	player_Club
player_Pat-Noonan_POS	player_Pat-Noonan	player_POS
player_Pat-Noonan_GP	player_Pat-Noonan	player_GP
player_Pat-Noonan_GS	player_Pat-Noonan	player_GS
player_Pat-Noonan_A	player_Pat-Noonan	player_A
player_Pat-Noonan_GWA	player_Pat-Noonan	player_GWA
player_Pat-Noonan_HmA	player_Pat-Noonan	player_HmA
player_Pat-Noonan_RdA	player_Pat-Noonan	player_RdA
player_Pat-Noonan_A.90min	player_Pat-Noonan	player_A.90min
player_Stuart-Holden_Club	player_Stuart-Holden	player_Club
player_Stuart-Holden_POS	player_Stuart-Holden	player_POS
player_Stuart-Holden_GP	player_Stuart-Holden	player_GP
player_Stuart-Holden_GS	player_Stuart-Holden	player_GS
player_Stuart-Holden_A	player_Stuart-Holden	player_A
player_Stuart-Holden_GWA	player_Stuart-Holden	player_GWA
player_Stuart-Holden_HmA	player_Stuart-Holden	player_HmA
player_Stuart-Holden_RdA	player_Stuart-Holden	player_RdA
player_Stuart-Holden_A.90min	player_Stuart-Holden	player_A.90min
player_Corey-Ashe_Club	player_Corey-Ashe	player_Club
player_Corey-Ashe_POS	player_Corey-Ashe	player_POS
player_Corey-Ashe_GP	player_Corey-Ashe	player_GP
player_Corey-Ashe_GS	player_Corey-Ashe	player_GS
player_Corey-Ashe_A	player_Corey-Ashe	player_A
player_Corey-Ashe_GWA	player_Corey-Ashe	player_GWA
player_Corey-Ashe_HmA	player_Corey-Ashe	player_HmA
player_Corey-Ashe_RdA	player_Corey-Ashe	player_RdA
player_Corey-Ashe_A.90min	player_Corey-Ashe	player_A.90min
