player_Marco-Etcheverry_Club	player_Marco-Etcheverry	player_Club
player_Marco-Etcheverry_POS	player_Marco-Etcheverry	player_POS
player_Marco-Etcheverry_GP	player_Marco-Etcheverry	player_GP
player_Marco-Etcheverry_GS	player_Marco-Etcheverry	player_GS
player_Marco-Etcheverry_A	player_Marco-Etcheverry	player_A
player_Marco-Etcheverry_GWA	player_Marco-Etcheverry	player_GWA
player_Marco-Etcheverry_HmA	player_Marco-Etcheverry	player_HmA
player_Marco-Etcheverry_RdA	player_Marco-Etcheverry	player_RdA
player_Marco-Etcheverry_A/90min	player_Marco-Etcheverry	player_A/90min
player_Carlos-Valderrama_Club	player_Carlos-Valderrama	player_Club
player_Carlos-Valderrama_POS	player_Carlos-Valderrama	player_POS
player_Carlos-Valderrama_GP	player_Carlos-Valderrama	player_GP
player_Carlos-Valderrama_GS	player_Carlos-Valderrama	player_GS
player_Carlos-Valderrama_A	player_Carlos-Valderrama	player_A
player_Carlos-Valderrama_GWA	player_Carlos-Valderrama	player_GWA
player_Carlos-Valderrama_HmA	player_Carlos-Valderrama	player_HmA
player_Carlos-Valderrama_RdA	player_Carlos-Valderrama	player_RdA
player_Carlos-Valderrama_A/90min	player_Carlos-Valderrama	player_A/90min
player_Eric-Wynalda_Club	player_Eric-Wynalda	player_Club
player_Eric-Wynalda_POS	player_Eric-Wynalda	player_POS
player_Eric-Wynalda_GP	player_Eric-Wynalda	player_GP
player_Eric-Wynalda_GS	player_Eric-Wynalda	player_GS
player_Eric-Wynalda_A	player_Eric-Wynalda	player_A
player_Eric-Wynalda_GWA	player_Eric-Wynalda	player_GWA
player_Eric-Wynalda_HmA	player_Eric-Wynalda	player_HmA
player_Eric-Wynalda_RdA	player_Eric-Wynalda	player_RdA
player_Eric-Wynalda_A/90min	player_Eric-Wynalda	player_A/90min
player_Preki_Club	player_Preki	player_Club
player_Preki_POS	player_Preki	player_POS
player_Preki_GP	player_Preki	player_GP
player_Preki_GS	player_Preki	player_GS
player_Preki_A	player_Preki	player_A
player_Preki_GWA	player_Preki	player_GWA
player_Preki_HmA	player_Preki	player_HmA
player_Preki_RdA	player_Preki	player_RdA
player_Preki_A/90min	player_Preki	player_A/90min
player_Robert-Warzycha_Club	player_Robert-Warzycha	player_Club
player_Robert-Warzycha_POS	player_Robert-Warzycha	player_POS
player_Robert-Warzycha_GP	player_Robert-Warzycha	player_GP
player_Robert-Warzycha_GS	player_Robert-Warzycha	player_GS
player_Robert-Warzycha_A	player_Robert-Warzycha	player_A
player_Robert-Warzycha_GWA	player_Robert-Warzycha	player_GWA
player_Robert-Warzycha_HmA	player_Robert-Warzycha	player_HmA
player_Robert-Warzycha_RdA	player_Robert-Warzycha	player_RdA
player_Robert-Warzycha_A/90min	player_Robert-Warzycha	player_A/90min
player_Mauricio-Cienfuegos_Club	player_Mauricio-Cienfuegos	player_Club
player_Mauricio-Cienfuegos_POS	player_Mauricio-Cienfuegos	player_POS
player_Mauricio-Cienfuegos_GP	player_Mauricio-Cienfuegos	player_GP
player_Mauricio-Cienfuegos_GS	player_Mauricio-Cienfuegos	player_GS
player_Mauricio-Cienfuegos_A	player_Mauricio-Cienfuegos	player_A
player_Mauricio-Cienfuegos_GWA	player_Mauricio-Cienfuegos	player_GWA
player_Mauricio-Cienfuegos_HmA	player_Mauricio-Cienfuegos	player_HmA
player_Mauricio-Cienfuegos_RdA	player_Mauricio-Cienfuegos	player_RdA
player_Mauricio-Cienfuegos_A/90min	player_Mauricio-Cienfuegos	player_A/90min
player_Adrian-Paz_Club	player_Adrian-Paz	player_Club
player_Adrian-Paz_POS	player_Adrian-Paz	player_POS
player_Adrian-Paz_GP	player_Adrian-Paz	player_GP
player_Adrian-Paz_GS	player_Adrian-Paz	player_GS
player_Adrian-Paz_A	player_Adrian-Paz	player_A
player_Adrian-Paz_GWA	player_Adrian-Paz	player_GWA
player_Adrian-Paz_HmA	player_Adrian-Paz	player_HmA
player_Adrian-Paz_RdA	player_Adrian-Paz	player_RdA
player_Adrian-Paz_A/90min	player_Adrian-Paz	player_A/90min
player_Tab-Ramos_Club	player_Tab-Ramos	player_Club
player_Tab-Ramos_POS	player_Tab-Ramos	player_POS
player_Tab-Ramos_GP	player_Tab-Ramos	player_GP
player_Tab-Ramos_GS	player_Tab-Ramos	player_GS
player_Tab-Ramos_A	player_Tab-Ramos	player_A
player_Tab-Ramos_GWA	player_Tab-Ramos	player_GWA
player_Tab-Ramos_HmA	player_Tab-Ramos	player_HmA
player_Tab-Ramos_RdA	player_Tab-Ramos	player_RdA
player_Tab-Ramos_A/90min	player_Tab-Ramos	player_A/90min
player_Mark-Chung_Club	player_Mark-Chung	player_Club
player_Mark-Chung_POS	player_Mark-Chung	player_POS
player_Mark-Chung_GP	player_Mark-Chung	player_GP
player_Mark-Chung_GS	player_Mark-Chung	player_GS
player_Mark-Chung_A	player_Mark-Chung	player_A
player_Mark-Chung_GWA	player_Mark-Chung	player_GWA
player_Mark-Chung_HmA	player_Mark-Chung	player_HmA
player_Mark-Chung_RdA	player_Mark-Chung	player_RdA
player_Mark-Chung_A/90min	player_Mark-Chung	player_A/90min
player_Roberto-Donadoni_Club	player_Roberto-Donadoni	player_Club
player_Roberto-Donadoni_POS	player_Roberto-Donadoni	player_POS
player_Roberto-Donadoni_GP	player_Roberto-Donadoni	player_GP
player_Roberto-Donadoni_GS	player_Roberto-Donadoni	player_GS
player_Roberto-Donadoni_A	player_Roberto-Donadoni	player_A
player_Roberto-Donadoni_GWA	player_Roberto-Donadoni	player_GWA
player_Roberto-Donadoni_HmA	player_Roberto-Donadoni	player_HmA
player_Roberto-Donadoni_RdA	player_Roberto-Donadoni	player_RdA
player_Roberto-Donadoni_A/90min	player_Roberto-Donadoni	player_A/90min
player_Giuseppe-Galderisi_Club	player_Giuseppe-Galderisi	player_Club
player_Giuseppe-Galderisi_POS	player_Giuseppe-Galderisi	player_POS
player_Giuseppe-Galderisi_GP	player_Giuseppe-Galderisi	player_GP
player_Giuseppe-Galderisi_GS	player_Giuseppe-Galderisi	player_GS
player_Giuseppe-Galderisi_A	player_Giuseppe-Galderisi	player_A
player_Giuseppe-Galderisi_GWA	player_Giuseppe-Galderisi	player_GWA
player_Giuseppe-Galderisi_HmA	player_Giuseppe-Galderisi	player_HmA
player_Giuseppe-Galderisi_RdA	player_Giuseppe-Galderisi	player_RdA
player_Giuseppe-Galderisi_A/90min	player_Giuseppe-Galderisi	player_A/90min
player_Tony-Sanneh_Club	player_Tony-Sanneh	player_Club
player_Tony-Sanneh_POS	player_Tony-Sanneh	player_POS
player_Tony-Sanneh_GP	player_Tony-Sanneh	player_GP
player_Tony-Sanneh_GS	player_Tony-Sanneh	player_GS
player_Tony-Sanneh_A	player_Tony-Sanneh	player_A
player_Tony-Sanneh_GWA	player_Tony-Sanneh	player_GWA
player_Tony-Sanneh_HmA	player_Tony-Sanneh	player_HmA
player_Tony-Sanneh_RdA	player_Tony-Sanneh	player_RdA
player_Tony-Sanneh_A/90min	player_Tony-Sanneh	player_A/90min
player_Billy-Thompson_Club	player_Billy-Thompson	player_Club
player_Billy-Thompson_POS	player_Billy-Thompson	player_POS
player_Billy-Thompson_GP	player_Billy-Thompson	player_GP
player_Billy-Thompson_GS	player_Billy-Thompson	player_GS
player_Billy-Thompson_A	player_Billy-Thompson	player_A
player_Billy-Thompson_GWA	player_Billy-Thompson	player_GWA
player_Billy-Thompson_HmA	player_Billy-Thompson	player_HmA
player_Billy-Thompson_RdA	player_Billy-Thompson	player_RdA
player_Billy-Thompson_A/90min	player_Billy-Thompson	player_A/90min
player_Ben-Iroha_Club	player_Ben-Iroha	player_Club
player_Ben-Iroha_POS	player_Ben-Iroha	player_POS
player_Ben-Iroha_GP	player_Ben-Iroha	player_GP
player_Ben-Iroha_GS	player_Ben-Iroha	player_GS
player_Ben-Iroha_A	player_Ben-Iroha	player_A
player_Ben-Iroha_GWA	player_Ben-Iroha	player_GWA
player_Ben-Iroha_HmA	player_Ben-Iroha	player_HmA
player_Ben-Iroha_RdA	player_Ben-Iroha	player_RdA
player_Ben-Iroha_A/90min	player_Ben-Iroha	player_A/90min
player_John-Harkes_Club	player_John-Harkes	player_Club
player_John-Harkes_POS	player_John-Harkes	player_POS
player_John-Harkes_GP	player_John-Harkes	player_GP
player_John-Harkes_GS	player_John-Harkes	player_GS
player_John-Harkes_A	player_John-Harkes	player_A
player_John-Harkes_GWA	player_John-Harkes	player_GWA
player_John-Harkes_HmA	player_John-Harkes	player_HmA
player_John-Harkes_RdA	player_John-Harkes	player_RdA
player_John-Harkes_A/90min	player_John-Harkes	player_A/90min
player_Chris-Henderson_Club	player_Chris-Henderson	player_Club
player_Chris-Henderson_POS	player_Chris-Henderson	player_POS
player_Chris-Henderson_GP	player_Chris-Henderson	player_GP
player_Chris-Henderson_GS	player_Chris-Henderson	player_GS
player_Chris-Henderson_A	player_Chris-Henderson	player_A
player_Chris-Henderson_GWA	player_Chris-Henderson	player_GWA
player_Chris-Henderson_HmA	player_Chris-Henderson	player_HmA
player_Chris-Henderson_RdA	player_Chris-Henderson	player_RdA
player_Chris-Henderson_A/90min	player_Chris-Henderson	player_A/90min
player_Gerell-Elliott_Club	player_Gerell-Elliott	player_Club
player_Gerell-Elliott_POS	player_Gerell-Elliott	player_POS
player_Gerell-Elliott_GP	player_Gerell-Elliott	player_GP
player_Gerell-Elliott_GS	player_Gerell-Elliott	player_GS
player_Gerell-Elliott_A	player_Gerell-Elliott	player_A
player_Gerell-Elliott_GWA	player_Gerell-Elliott	player_GWA
player_Gerell-Elliott_HmA	player_Gerell-Elliott	player_HmA
player_Gerell-Elliott_RdA	player_Gerell-Elliott	player_RdA
player_Gerell-Elliott_A/90min	player_Gerell-Elliott	player_A/90min
player_Alberto-Naveda_Club	player_Alberto-Naveda	player_Club
player_Alberto-Naveda_POS	player_Alberto-Naveda	player_POS
player_Alberto-Naveda_GP	player_Alberto-Naveda	player_GP
player_Alberto-Naveda_GS	player_Alberto-Naveda	player_GS
player_Alberto-Naveda_A	player_Alberto-Naveda	player_A
player_Alberto-Naveda_GWA	player_Alberto-Naveda	player_GWA
player_Alberto-Naveda_HmA	player_Alberto-Naveda	player_HmA
player_Alberto-Naveda_RdA	player_Alberto-Naveda	player_RdA
player_Alberto-Naveda_A/90min	player_Alberto-Naveda	player_A/90min
player_Vitalis-Takawira_Club	player_Vitalis-Takawira	player_Club
player_Vitalis-Takawira_POS	player_Vitalis-Takawira	player_POS
player_Vitalis-Takawira_GP	player_Vitalis-Takawira	player_GP
player_Vitalis-Takawira_GS	player_Vitalis-Takawira	player_GS
player_Vitalis-Takawira_A	player_Vitalis-Takawira	player_A
player_Vitalis-Takawira_GWA	player_Vitalis-Takawira	player_GWA
player_Vitalis-Takawira_HmA	player_Vitalis-Takawira	player_HmA
player_Vitalis-Takawira_RdA	player_Vitalis-Takawira	player_RdA
player_Vitalis-Takawira_A/90min	player_Vitalis-Takawira	player_A/90min
player_Shaun-Bartlett_Club	player_Shaun-Bartlett	player_Club
player_Shaun-Bartlett_POS	player_Shaun-Bartlett	player_POS
player_Shaun-Bartlett_GP	player_Shaun-Bartlett	player_GP
player_Shaun-Bartlett_GS	player_Shaun-Bartlett	player_GS
player_Shaun-Bartlett_A	player_Shaun-Bartlett	player_A
player_Shaun-Bartlett_GWA	player_Shaun-Bartlett	player_GWA
player_Shaun-Bartlett_HmA	player_Shaun-Bartlett	player_HmA
player_Shaun-Bartlett_RdA	player_Shaun-Bartlett	player_RdA
player_Shaun-Bartlett_A/90min	player_Shaun-Bartlett	player_A/90min
player_Eduardo-Hurtado_Club	player_Eduardo-Hurtado	player_Club
player_Eduardo-Hurtado_POS	player_Eduardo-Hurtado	player_POS
player_Eduardo-Hurtado_GP	player_Eduardo-Hurtado	player_GP
player_Eduardo-Hurtado_GS	player_Eduardo-Hurtado	player_GS
player_Eduardo-Hurtado_A	player_Eduardo-Hurtado	player_A
player_Eduardo-Hurtado_GWA	player_Eduardo-Hurtado	player_GWA
player_Eduardo-Hurtado_HmA	player_Eduardo-Hurtado	player_HmA
player_Eduardo-Hurtado_RdA	player_Eduardo-Hurtado	player_RdA
player_Eduardo-Hurtado_A/90min	player_Eduardo-Hurtado	player_A/90min
player_Diego-Sonora_Club	player_Diego-Sonora	player_Club
player_Diego-Sonora_POS	player_Diego-Sonora	player_POS
player_Diego-Sonora_GP	player_Diego-Sonora	player_GP
player_Diego-Sonora_GS	player_Diego-Sonora	player_GS
player_Diego-Sonora_A	player_Diego-Sonora	player_A
player_Diego-Sonora_GWA	player_Diego-Sonora	player_GWA
player_Diego-Sonora_HmA	player_Diego-Sonora	player_HmA
player_Diego-Sonora_RdA	player_Diego-Sonora	player_RdA
player_Diego-Sonora_A/90min	player_Diego-Sonora	player_A/90min
player_Roy-Wegerle_Club	player_Roy-Wegerle	player_Club
player_Roy-Wegerle_POS	player_Roy-Wegerle	player_POS
player_Roy-Wegerle_GP	player_Roy-Wegerle	player_GP
player_Roy-Wegerle_GS	player_Roy-Wegerle	player_GS
player_Roy-Wegerle_A	player_Roy-Wegerle	player_A
player_Roy-Wegerle_GWA	player_Roy-Wegerle	player_GWA
player_Roy-Wegerle_HmA	player_Roy-Wegerle	player_HmA
player_Roy-Wegerle_RdA	player_Roy-Wegerle	player_RdA
player_Roy-Wegerle_A/90min	player_Roy-Wegerle	player_A/90min
player_Ted-Eck_Club	player_Ted-Eck	player_Club
player_Ted-Eck_POS	player_Ted-Eck	player_POS
player_Ted-Eck_GP	player_Ted-Eck	player_GP
player_Ted-Eck_GS	player_Ted-Eck	player_GS
player_Ted-Eck_A	player_Ted-Eck	player_A
player_Ted-Eck_GWA	player_Ted-Eck	player_GWA
player_Ted-Eck_HmA	player_Ted-Eck	player_HmA
player_Ted-Eck_RdA	player_Ted-Eck	player_RdA
player_Ted-Eck_A/90min	player_Ted-Eck	player_A/90min
player_Welton_Club	player_Welton	player_Club
player_Welton_POS	player_Welton	player_POS
player_Welton_GP	player_Welton	player_GP
player_Welton_GS	player_Welton	player_GS
player_Welton_A	player_Welton	player_A
player_Welton_GWA	player_Welton	player_GWA
player_Welton_HmA	player_Welton	player_HmA
player_Welton_RdA	player_Welton	player_RdA
player_Welton_A/90min	player_Welton	player_A/90min
player_Mike-Sorber_Club	player_Mike-Sorber	player_Club
player_Mike-Sorber_POS	player_Mike-Sorber	player_POS
player_Mike-Sorber_GP	player_Mike-Sorber	player_GP
player_Mike-Sorber_GS	player_Mike-Sorber	player_GS
player_Mike-Sorber_A	player_Mike-Sorber	player_A
player_Mike-Sorber_GWA	player_Mike-Sorber	player_GWA
player_Mike-Sorber_HmA	player_Mike-Sorber	player_HmA
player_Mike-Sorber_RdA	player_Mike-Sorber	player_RdA
player_Mike-Sorber_A/90min	player_Mike-Sorber	player_A/90min
player_Ivan-McKinley_Club	player_Ivan-McKinley	player_Club
player_Ivan-McKinley_POS	player_Ivan-McKinley	player_POS
player_Ivan-McKinley_GP	player_Ivan-McKinley	player_GP
player_Ivan-McKinley_GS	player_Ivan-McKinley	player_GS
player_Ivan-McKinley_A	player_Ivan-McKinley	player_A
player_Ivan-McKinley_GWA	player_Ivan-McKinley	player_GWA
player_Ivan-McKinley_HmA	player_Ivan-McKinley	player_HmA
player_Ivan-McKinley_RdA	player_Ivan-McKinley	player_RdA
player_Ivan-McKinley_A/90min	player_Ivan-McKinley	player_A/90min
player_Steve-Pittman_Club	player_Steve-Pittman	player_Club
player_Steve-Pittman_POS	player_Steve-Pittman	player_POS
player_Steve-Pittman_GP	player_Steve-Pittman	player_GP
player_Steve-Pittman_GS	player_Steve-Pittman	player_GS
player_Steve-Pittman_A	player_Steve-Pittman	player_A
player_Steve-Pittman_GWA	player_Steve-Pittman	player_GWA
player_Steve-Pittman_HmA	player_Steve-Pittman	player_HmA
player_Steve-Pittman_RdA	player_Steve-Pittman	player_RdA
player_Steve-Pittman_A/90min	player_Steve-Pittman	player_A/90min
player_John-Doyle_Club	player_John-Doyle	player_Club
player_John-Doyle_POS	player_John-Doyle	player_POS
player_John-Doyle_GP	player_John-Doyle	player_GP
player_John-Doyle_GS	player_John-Doyle	player_GS
player_John-Doyle_A	player_John-Doyle	player_A
player_John-Doyle_GWA	player_John-Doyle	player_GWA
player_John-Doyle_HmA	player_John-Doyle	player_HmA
player_John-Doyle_RdA	player_John-Doyle	player_RdA
player_John-Doyle_A/90min	player_John-Doyle	player_A/90min
player_Martin-Vasquez_Club	player_Martin-Vasquez	player_Club
player_Martin-Vasquez_POS	player_Martin-Vasquez	player_POS
player_Martin-Vasquez_GP	player_Martin-Vasquez	player_GP
player_Martin-Vasquez_GS	player_Martin-Vasquez	player_GS
player_Martin-Vasquez_A	player_Martin-Vasquez	player_A
player_Martin-Vasquez_GWA	player_Martin-Vasquez	player_GWA
player_Martin-Vasquez_HmA	player_Martin-Vasquez	player_HmA
player_Martin-Vasquez_RdA	player_Martin-Vasquez	player_RdA
player_Martin-Vasquez_A/90min	player_Martin-Vasquez	player_A/90min
player_Darren-Sawatzky_Club	player_Darren-Sawatzky	player_Club
player_Darren-Sawatzky_POS	player_Darren-Sawatzky	player_POS
player_Darren-Sawatzky_GP	player_Darren-Sawatzky	player_GP
player_Darren-Sawatzky_GS	player_Darren-Sawatzky	player_GS
player_Darren-Sawatzky_A	player_Darren-Sawatzky	player_A
player_Darren-Sawatzky_GWA	player_Darren-Sawatzky	player_GWA
player_Darren-Sawatzky_HmA	player_Darren-Sawatzky	player_HmA
player_Darren-Sawatzky_RdA	player_Darren-Sawatzky	player_RdA
player_Darren-Sawatzky_A/90min	player_Darren-Sawatzky	player_A/90min
player_Leonel-Alvarez_Club	player_Leonel-Alvarez	player_Club
player_Leonel-Alvarez_POS	player_Leonel-Alvarez	player_POS
player_Leonel-Alvarez_GP	player_Leonel-Alvarez	player_GP
player_Leonel-Alvarez_GS	player_Leonel-Alvarez	player_GS
player_Leonel-Alvarez_A	player_Leonel-Alvarez	player_A
player_Leonel-Alvarez_GWA	player_Leonel-Alvarez	player_GWA
player_Leonel-Alvarez_HmA	player_Leonel-Alvarez	player_HmA
player_Leonel-Alvarez_RdA	player_Leonel-Alvarez	player_RdA
player_Leonel-Alvarez_A/90min	player_Leonel-Alvarez	player_A/90min
player_Eduardo-Espinoza_Club	player_Eduardo-Espinoza	player_Club
player_Eduardo-Espinoza_POS	player_Eduardo-Espinoza	player_POS
player_Eduardo-Espinoza_GP	player_Eduardo-Espinoza	player_GP
player_Eduardo-Espinoza_GS	player_Eduardo-Espinoza	player_GS
player_Eduardo-Espinoza_A	player_Eduardo-Espinoza	player_A
player_Eduardo-Espinoza_GWA	player_Eduardo-Espinoza	player_GWA
player_Eduardo-Espinoza_HmA	player_Eduardo-Espinoza	player_HmA
player_Eduardo-Espinoza_RdA	player_Eduardo-Espinoza	player_RdA
player_Eduardo-Espinoza_A/90min	player_Eduardo-Espinoza	player_A/90min
player_Jason-Kreis_Club	player_Jason-Kreis	player_Club
player_Jason-Kreis_POS	player_Jason-Kreis	player_POS
player_Jason-Kreis_GP	player_Jason-Kreis	player_GP
player_Jason-Kreis_GS	player_Jason-Kreis	player_GS
player_Jason-Kreis_A	player_Jason-Kreis	player_A
player_Jason-Kreis_GWA	player_Jason-Kreis	player_GWA
player_Jason-Kreis_HmA	player_Jason-Kreis	player_HmA
player_Jason-Kreis_RdA	player_Jason-Kreis	player_RdA
player_Jason-Kreis_A/90min	player_Jason-Kreis	player_A/90min
player_Richie-Williams_Club	player_Richie-Williams	player_Club
player_Richie-Williams_POS	player_Richie-Williams	player_POS
player_Richie-Williams_GP	player_Richie-Williams	player_GP
player_Richie-Williams_GS	player_Richie-Williams	player_GS
player_Richie-Williams_A	player_Richie-Williams	player_A
player_Richie-Williams_GWA	player_Richie-Williams	player_GWA
player_Richie-Williams_HmA	player_Richie-Williams	player_HmA
player_Richie-Williams_RdA	player_Richie-Williams	player_RdA
player_Richie-Williams_A/90min	player_Richie-Williams	player_A/90min
player_Paul-Bravo_Club	player_Paul-Bravo	player_Club
player_Paul-Bravo_POS	player_Paul-Bravo	player_POS
player_Paul-Bravo_GP	player_Paul-Bravo	player_GP
player_Paul-Bravo_GS	player_Paul-Bravo	player_GS
player_Paul-Bravo_A	player_Paul-Bravo	player_A
player_Paul-Bravo_GWA	player_Paul-Bravo	player_GWA
player_Paul-Bravo_HmA	player_Paul-Bravo	player_HmA
player_Paul-Bravo_RdA	player_Paul-Bravo	player_RdA
player_Paul-Bravo_A/90min	player_Paul-Bravo	player_A/90min
player_Jeff-Agoos_Club	player_Jeff-Agoos	player_Club
player_Jeff-Agoos_POS	player_Jeff-Agoos	player_POS
player_Jeff-Agoos_GP	player_Jeff-Agoos	player_GP
player_Jeff-Agoos_GS	player_Jeff-Agoos	player_GS
player_Jeff-Agoos_A	player_Jeff-Agoos	player_A
player_Jeff-Agoos_GWA	player_Jeff-Agoos	player_GWA
player_Jeff-Agoos_HmA	player_Jeff-Agoos	player_HmA
player_Jeff-Agoos_RdA	player_Jeff-Agoos	player_RdA
player_Jeff-Agoos_A/90min	player_Jeff-Agoos	player_A/90min
player_Scott-Benedetti_Club	player_Scott-Benedetti	player_Club
player_Scott-Benedetti_POS	player_Scott-Benedetti	player_POS
player_Scott-Benedetti_GP	player_Scott-Benedetti	player_GP
player_Scott-Benedetti_GS	player_Scott-Benedetti	player_GS
player_Scott-Benedetti_A	player_Scott-Benedetti	player_A
player_Scott-Benedetti_GWA	player_Scott-Benedetti	player_GWA
player_Scott-Benedetti_HmA	player_Scott-Benedetti	player_HmA
player_Scott-Benedetti_RdA	player_Scott-Benedetti	player_RdA
player_Scott-Benedetti_A/90min	player_Scott-Benedetti	player_A/90min
player_Guillermo-Jara_Club	player_Guillermo-Jara	player_Club
player_Guillermo-Jara_POS	player_Guillermo-Jara	player_POS
player_Guillermo-Jara_GP	player_Guillermo-Jara	player_GP
player_Guillermo-Jara_GS	player_Guillermo-Jara	player_GS
player_Guillermo-Jara_A	player_Guillermo-Jara	player_A
player_Guillermo-Jara_GWA	player_Guillermo-Jara	player_GWA
player_Guillermo-Jara_HmA	player_Guillermo-Jara	player_HmA
player_Guillermo-Jara_RdA	player_Guillermo-Jara	player_RdA
player_Guillermo-Jara_A/90min	player_Guillermo-Jara	player_A/90min
player_Frank-Klopas_Club	player_Frank-Klopas	player_Club
player_Frank-Klopas_POS	player_Frank-Klopas	player_POS
player_Frank-Klopas_GP	player_Frank-Klopas	player_GP
player_Frank-Klopas_GS	player_Frank-Klopas	player_GS
player_Frank-Klopas_A	player_Frank-Klopas	player_A
player_Frank-Klopas_GWA	player_Frank-Klopas	player_GWA
player_Frank-Klopas_HmA	player_Frank-Klopas	player_HmA
player_Frank-Klopas_RdA	player_Frank-Klopas	player_RdA
player_Frank-Klopas_A/90min	player_Frank-Klopas	player_A/90min
player_John-DeBrito_Club	player_John-DeBrito	player_Club
player_John-DeBrito_POS	player_John-DeBrito	player_POS
player_John-DeBrito_GP	player_John-DeBrito	player_GP
player_John-DeBrito_GS	player_John-DeBrito	player_GS
player_John-DeBrito_A	player_John-DeBrito	player_A
player_John-DeBrito_GWA	player_John-DeBrito	player_GWA
player_John-DeBrito_HmA	player_John-DeBrito	player_HmA
player_John-DeBrito_RdA	player_John-DeBrito	player_RdA
player_John-DeBrito_A/90min	player_John-DeBrito	player_A/90min
player_Pete-Marino_Club	player_Pete-Marino	player_Club
player_Pete-Marino_POS	player_Pete-Marino	player_POS
player_Pete-Marino_GP	player_Pete-Marino	player_GP
player_Pete-Marino_GS	player_Pete-Marino	player_GS
player_Pete-Marino_A	player_Pete-Marino	player_A
player_Pete-Marino_GWA	player_Pete-Marino	player_GWA
player_Pete-Marino_HmA	player_Pete-Marino	player_HmA
player_Pete-Marino_RdA	player_Pete-Marino	player_RdA
player_Pete-Marino_A/90min	player_Pete-Marino	player_A/90min
player_Miles-Joseph_Club	player_Miles-Joseph	player_Club
player_Miles-Joseph_POS	player_Miles-Joseph	player_POS
player_Miles-Joseph_GP	player_Miles-Joseph	player_GP
player_Miles-Joseph_GS	player_Miles-Joseph	player_GS
player_Miles-Joseph_A	player_Miles-Joseph	player_A
player_Miles-Joseph_GWA	player_Miles-Joseph	player_GWA
player_Miles-Joseph_HmA	player_Miles-Joseph	player_HmA
player_Miles-Joseph_RdA	player_Miles-Joseph	player_RdA
player_Miles-Joseph_A/90min	player_Miles-Joseph	player_A/90min
player_Diego-Gutierrez_Club	player_Diego-Gutierrez	player_Club
player_Diego-Gutierrez_POS	player_Diego-Gutierrez	player_POS
player_Diego-Gutierrez_GP	player_Diego-Gutierrez	player_GP
player_Diego-Gutierrez_GS	player_Diego-Gutierrez	player_GS
player_Diego-Gutierrez_A	player_Diego-Gutierrez	player_A
player_Diego-Gutierrez_GWA	player_Diego-Gutierrez	player_GWA
player_Diego-Gutierrez_HmA	player_Diego-Gutierrez	player_HmA
player_Diego-Gutierrez_RdA	player_Diego-Gutierrez	player_RdA
player_Diego-Gutierrez_A/90min	player_Diego-Gutierrez	player_A/90min
player_Jean-Harbor_Club	player_Jean-Harbor	player_Club
player_Jean-Harbor_POS	player_Jean-Harbor	player_POS
player_Jean-Harbor_GP	player_Jean-Harbor	player_GP
player_Jean-Harbor_GS	player_Jean-Harbor	player_GS
player_Jean-Harbor_A	player_Jean-Harbor	player_A
player_Jean-Harbor_GWA	player_Jean-Harbor	player_GWA
player_Jean-Harbor_HmA	player_Jean-Harbor	player_HmA
player_Jean-Harbor_RdA	player_Jean-Harbor	player_RdA
player_Jean-Harbor_A/90min	player_Jean-Harbor	player_A/90min
player_Cobi-Jones_Club	player_Cobi-Jones	player_Club
player_Cobi-Jones_POS	player_Cobi-Jones	player_POS
player_Cobi-Jones_GP	player_Cobi-Jones	player_GP
player_Cobi-Jones_GS	player_Cobi-Jones	player_GS
player_Cobi-Jones_A	player_Cobi-Jones	player_A
player_Cobi-Jones_GWA	player_Cobi-Jones	player_GWA
player_Cobi-Jones_HmA	player_Cobi-Jones	player_HmA
player_Cobi-Jones_RdA	player_Cobi-Jones	player_RdA
player_Cobi-Jones_A/90min	player_Cobi-Jones	player_A/90min
player_Roy-Lassiter_Club	player_Roy-Lassiter	player_Club
player_Roy-Lassiter_POS	player_Roy-Lassiter	player_POS
player_Roy-Lassiter_GP	player_Roy-Lassiter	player_GP
player_Roy-Lassiter_GS	player_Roy-Lassiter	player_GS
player_Roy-Lassiter_A	player_Roy-Lassiter	player_A
player_Roy-Lassiter_GWA	player_Roy-Lassiter	player_GWA
player_Roy-Lassiter_HmA	player_Roy-Lassiter	player_HmA
player_Roy-Lassiter_RdA	player_Roy-Lassiter	player_RdA
player_Roy-Lassiter_A/90min	player_Roy-Lassiter	player_A/90min
player_Paul-Wright_Club	player_Paul-Wright	player_Club
player_Paul-Wright_POS	player_Paul-Wright	player_POS
player_Paul-Wright_GP	player_Paul-Wright	player_GP
player_Paul-Wright_GS	player_Paul-Wright	player_GS
player_Paul-Wright_A	player_Paul-Wright	player_A
player_Paul-Wright_GWA	player_Paul-Wright	player_GWA
player_Paul-Wright_HmA	player_Paul-Wright	player_HmA
player_Paul-Wright_RdA	player_Paul-Wright	player_RdA
player_Paul-Wright_A/90min	player_Paul-Wright	player_A/90min
player_Jaime-Moreno_Club	player_Jaime-Moreno	player_Club
player_Jaime-Moreno_POS	player_Jaime-Moreno	player_POS
player_Jaime-Moreno_GP	player_Jaime-Moreno	player_GP
player_Jaime-Moreno_GS	player_Jaime-Moreno	player_GS
player_Jaime-Moreno_A	player_Jaime-Moreno	player_A
player_Jaime-Moreno_GWA	player_Jaime-Moreno	player_GWA
player_Jaime-Moreno_HmA	player_Jaime-Moreno	player_HmA
player_Jaime-Moreno_RdA	player_Jaime-Moreno	player_RdA
player_Jaime-Moreno_A/90min	player_Jaime-Moreno	player_A/90min
player_Kris-Kelderman_Club	player_Kris-Kelderman	player_Club
player_Kris-Kelderman_POS	player_Kris-Kelderman	player_POS
player_Kris-Kelderman_GP	player_Kris-Kelderman	player_GP
player_Kris-Kelderman_GS	player_Kris-Kelderman	player_GS
player_Kris-Kelderman_A	player_Kris-Kelderman	player_A
player_Kris-Kelderman_GWA	player_Kris-Kelderman	player_GWA
player_Kris-Kelderman_HmA	player_Kris-Kelderman	player_HmA
player_Kris-Kelderman_RdA	player_Kris-Kelderman	player_RdA
player_Kris-Kelderman_A/90min	player_Kris-Kelderman	player_A/90min
player_Ruben-Hernandez_Club	player_Ruben-Hernandez	player_Club
player_Ruben-Hernandez_POS	player_Ruben-Hernandez	player_POS
player_Ruben-Hernandez_GP	player_Ruben-Hernandez	player_GP
player_Ruben-Hernandez_GS	player_Ruben-Hernandez	player_GS
player_Ruben-Hernandez_A	player_Ruben-Hernandez	player_A
player_Ruben-Hernandez_GWA	player_Ruben-Hernandez	player_GWA
player_Ruben-Hernandez_HmA	player_Ruben-Hernandez	player_HmA
player_Ruben-Hernandez_RdA	player_Ruben-Hernandez	player_RdA
player_Ruben-Hernandez_A/90min	player_Ruben-Hernandez	player_A/90min
player_Rob-Johnson_Club	player_Rob-Johnson	player_Club
player_Rob-Johnson_POS	player_Rob-Johnson	player_POS
player_Rob-Johnson_GP	player_Rob-Johnson	player_GP
player_Rob-Johnson_GS	player_Rob-Johnson	player_GS
player_Rob-Johnson_A	player_Rob-Johnson	player_A
player_Rob-Johnson_GWA	player_Rob-Johnson	player_GWA
player_Rob-Johnson_HmA	player_Rob-Johnson	player_HmA
player_Rob-Johnson_RdA	player_Rob-Johnson	player_RdA
player_Rob-Johnson_A/90min	player_Rob-Johnson	player_A/90min
player_Eddie-Lewis_Club	player_Eddie-Lewis	player_Club
player_Eddie-Lewis_POS	player_Eddie-Lewis	player_POS
player_Eddie-Lewis_GP	player_Eddie-Lewis	player_GP
player_Eddie-Lewis_GS	player_Eddie-Lewis	player_GS
player_Eddie-Lewis_A	player_Eddie-Lewis	player_A
player_Eddie-Lewis_GWA	player_Eddie-Lewis	player_GWA
player_Eddie-Lewis_HmA	player_Eddie-Lewis	player_HmA
player_Eddie-Lewis_RdA	player_Eddie-Lewis	player_RdA
player_Eddie-Lewis_A/90min	player_Eddie-Lewis	player_A/90min
player_Evans-Wise_Club	player_Evans-Wise	player_Club
player_Evans-Wise_POS	player_Evans-Wise	player_POS
player_Evans-Wise_GP	player_Evans-Wise	player_GP
player_Evans-Wise_GS	player_Evans-Wise	player_GS
player_Evans-Wise_A	player_Evans-Wise	player_A
player_Evans-Wise_GWA	player_Evans-Wise	player_GWA
player_Evans-Wise_HmA	player_Evans-Wise	player_HmA
player_Evans-Wise_RdA	player_Evans-Wise	player_RdA
player_Evans-Wise_A/90min	player_Evans-Wise	player_A/90min
player_Peter-Woodring_Club	player_Peter-Woodring	player_Club
player_Peter-Woodring_POS	player_Peter-Woodring	player_POS
player_Peter-Woodring_GP	player_Peter-Woodring	player_GP
player_Peter-Woodring_GS	player_Peter-Woodring	player_GS
player_Peter-Woodring_A	player_Peter-Woodring	player_A
player_Peter-Woodring_GWA	player_Peter-Woodring	player_GWA
player_Peter-Woodring_HmA	player_Peter-Woodring	player_HmA
player_Peter-Woodring_RdA	player_Peter-Woodring	player_RdA
player_Peter-Woodring_A/90min	player_Peter-Woodring	player_A/90min
player_Steve-Rammel_Club	player_Steve-Rammel	player_Club
player_Steve-Rammel_POS	player_Steve-Rammel	player_POS
player_Steve-Rammel_GP	player_Steve-Rammel	player_GP
player_Steve-Rammel_GS	player_Steve-Rammel	player_GS
player_Steve-Rammel_A	player_Steve-Rammel	player_A
player_Steve-Rammel_GWA	player_Steve-Rammel	player_GWA
player_Steve-Rammel_HmA	player_Steve-Rammel	player_HmA
player_Steve-Rammel_RdA	player_Steve-Rammel	player_RdA
player_Steve-Rammel_A/90min	player_Steve-Rammel	player_A/90min
player_Hugo-Sanchez_Club	player_Hugo-Sanchez	player_Club
player_Hugo-Sanchez_POS	player_Hugo-Sanchez	player_POS
player_Hugo-Sanchez_GP	player_Hugo-Sanchez	player_GP
player_Hugo-Sanchez_GS	player_Hugo-Sanchez	player_GS
player_Hugo-Sanchez_A	player_Hugo-Sanchez	player_A
player_Hugo-Sanchez_GWA	player_Hugo-Sanchez	player_GWA
player_Hugo-Sanchez_HmA	player_Hugo-Sanchez	player_HmA
player_Hugo-Sanchez_RdA	player_Hugo-Sanchez	player_RdA
player_Hugo-Sanchez_A/90min	player_Hugo-Sanchez	player_A/90min
player_Jorge-Rodas_Club	player_Jorge-Rodas	player_Club
player_Jorge-Rodas_POS	player_Jorge-Rodas	player_POS
player_Jorge-Rodas_GP	player_Jorge-Rodas	player_GP
player_Jorge-Rodas_GS	player_Jorge-Rodas	player_GS
player_Jorge-Rodas_A	player_Jorge-Rodas	player_A
player_Jorge-Rodas_GWA	player_Jorge-Rodas	player_GWA
player_Jorge-Rodas_HmA	player_Jorge-Rodas	player_HmA
player_Jorge-Rodas_RdA	player_Jorge-Rodas	player_RdA
player_Jorge-Rodas_A/90min	player_Jorge-Rodas	player_A/90min
player_Paul-Keegan_Club	player_Paul-Keegan	player_Club
player_Paul-Keegan_POS	player_Paul-Keegan	player_POS
player_Paul-Keegan_GP	player_Paul-Keegan	player_GP
player_Paul-Keegan_GS	player_Paul-Keegan	player_GS
player_Paul-Keegan_A	player_Paul-Keegan	player_A
player_Paul-Keegan_GWA	player_Paul-Keegan	player_GWA
player_Paul-Keegan_HmA	player_Paul-Keegan	player_HmA
player_Paul-Keegan_RdA	player_Paul-Keegan	player_RdA
player_Paul-Keegan_A/90min	player_Paul-Keegan	player_A/90min
player_Mario-Gori_Club	player_Mario-Gori	player_Club
player_Mario-Gori_POS	player_Mario-Gori	player_POS
player_Mario-Gori_GP	player_Mario-Gori	player_GP
player_Mario-Gori_GS	player_Mario-Gori	player_GS
player_Mario-Gori_A	player_Mario-Gori	player_A
player_Mario-Gori_GWA	player_Mario-Gori	player_GWA
player_Mario-Gori_HmA	player_Mario-Gori	player_HmA
player_Mario-Gori_RdA	player_Mario-Gori	player_RdA
player_Mario-Gori_A/90min	player_Mario-Gori	player_A/90min
player_Brian-Haynes_Club	player_Brian-Haynes	player_Club
player_Brian-Haynes_POS	player_Brian-Haynes	player_POS
player_Brian-Haynes_GP	player_Brian-Haynes	player_GP
player_Brian-Haynes_GS	player_Brian-Haynes	player_GS
player_Brian-Haynes_A	player_Brian-Haynes	player_A
player_Brian-Haynes_GWA	player_Brian-Haynes	player_GWA
player_Brian-Haynes_HmA	player_Brian-Haynes	player_HmA
player_Brian-Haynes_RdA	player_Brian-Haynes	player_RdA
player_Brian-Haynes_A/90min	player_Brian-Haynes	player_A/90min
player_Troy-Dayak_Club	player_Troy-Dayak	player_Club
player_Troy-Dayak_POS	player_Troy-Dayak	player_POS
player_Troy-Dayak_GP	player_Troy-Dayak	player_GP
player_Troy-Dayak_GS	player_Troy-Dayak	player_GS
player_Troy-Dayak_A	player_Troy-Dayak	player_A
player_Troy-Dayak_GWA	player_Troy-Dayak	player_GWA
player_Troy-Dayak_HmA	player_Troy-Dayak	player_HmA
player_Troy-Dayak_RdA	player_Troy-Dayak	player_RdA
player_Troy-Dayak_A/90min	player_Troy-Dayak	player_A/90min
player_Brian-McBride_Club	player_Brian-McBride	player_Club
player_Brian-McBride_POS	player_Brian-McBride	player_POS
player_Brian-McBride_GP	player_Brian-McBride	player_GP
player_Brian-McBride_GS	player_Brian-McBride	player_GS
player_Brian-McBride_A	player_Brian-McBride	player_A
player_Brian-McBride_GWA	player_Brian-McBride	player_GWA
player_Brian-McBride_HmA	player_Brian-McBride	player_HmA
player_Brian-McBride_RdA	player_Brian-McBride	player_RdA
player_Brian-McBride_A/90min	player_Brian-McBride	player_A/90min
player_Cle-Kooiman_Club	player_Cle-Kooiman	player_Club
player_Cle-Kooiman_POS	player_Cle-Kooiman	player_POS
player_Cle-Kooiman_GP	player_Cle-Kooiman	player_GP
player_Cle-Kooiman_GS	player_Cle-Kooiman	player_GS
player_Cle-Kooiman_A	player_Cle-Kooiman	player_A
player_Cle-Kooiman_GWA	player_Cle-Kooiman	player_GWA
player_Cle-Kooiman_HmA	player_Cle-Kooiman	player_HmA
player_Cle-Kooiman_RdA	player_Cle-Kooiman	player_RdA
player_Cle-Kooiman_A/90min	player_Cle-Kooiman	player_A/90min
player_Geoff-Aunger_Club	player_Geoff-Aunger	player_Club
player_Geoff-Aunger_POS	player_Geoff-Aunger	player_POS
player_Geoff-Aunger_GP	player_Geoff-Aunger	player_GP
player_Geoff-Aunger_GS	player_Geoff-Aunger	player_GS
player_Geoff-Aunger_A	player_Geoff-Aunger	player_A
player_Geoff-Aunger_GWA	player_Geoff-Aunger	player_GWA
player_Geoff-Aunger_HmA	player_Geoff-Aunger	player_HmA
player_Geoff-Aunger_RdA	player_Geoff-Aunger	player_RdA
player_Geoff-Aunger_A/90min	player_Geoff-Aunger	player_A/90min
player_Maurice-Johnston_Club	player_Maurice-Johnston	player_Club
player_Maurice-Johnston_POS	player_Maurice-Johnston	player_POS
player_Maurice-Johnston_GP	player_Maurice-Johnston	player_GP
player_Maurice-Johnston_GS	player_Maurice-Johnston	player_GS
player_Maurice-Johnston_A	player_Maurice-Johnston	player_A
player_Maurice-Johnston_GWA	player_Maurice-Johnston	player_GWA
player_Maurice-Johnston_HmA	player_Maurice-Johnston	player_HmA
player_Maurice-Johnston_RdA	player_Maurice-Johnston	player_RdA
player_Maurice-Johnston_A/90min	player_Maurice-Johnston	player_A/90min
player_Sean-Bowers_Club	player_Sean-Bowers	player_Club
player_Sean-Bowers_POS	player_Sean-Bowers	player_POS
player_Sean-Bowers_GP	player_Sean-Bowers	player_GP
player_Sean-Bowers_GS	player_Sean-Bowers	player_GS
player_Sean-Bowers_A	player_Sean-Bowers	player_A
player_Sean-Bowers_GWA	player_Sean-Bowers	player_GWA
player_Sean-Bowers_HmA	player_Sean-Bowers	player_HmA
player_Sean-Bowers_RdA	player_Sean-Bowers	player_RdA
player_Sean-Bowers_A/90min	player_Sean-Bowers	player_A/90min
player_Felipe-Rodriguez_Club	player_Felipe-Rodriguez	player_Club
player_Felipe-Rodriguez_POS	player_Felipe-Rodriguez	player_POS
player_Felipe-Rodriguez_GP	player_Felipe-Rodriguez	player_GP
player_Felipe-Rodriguez_GS	player_Felipe-Rodriguez	player_GS
player_Felipe-Rodriguez_A	player_Felipe-Rodriguez	player_A
player_Felipe-Rodriguez_GWA	player_Felipe-Rodriguez	player_GWA
player_Felipe-Rodriguez_HmA	player_Felipe-Rodriguez	player_HmA
player_Felipe-Rodriguez_RdA	player_Felipe-Rodriguez	player_RdA
player_Felipe-Rodriguez_A/90min	player_Felipe-Rodriguez	player_A/90min
player_Eric-Eichmann_Club	player_Eric-Eichmann	player_Club
player_Eric-Eichmann_POS	player_Eric-Eichmann	player_POS
player_Eric-Eichmann_GP	player_Eric-Eichmann	player_GP
player_Eric-Eichmann_GS	player_Eric-Eichmann	player_GS
player_Eric-Eichmann_A	player_Eric-Eichmann	player_A
player_Eric-Eichmann_GWA	player_Eric-Eichmann	player_GWA
player_Eric-Eichmann_HmA	player_Eric-Eichmann	player_HmA
player_Eric-Eichmann_RdA	player_Eric-Eichmann	player_RdA
player_Eric-Eichmann_A/90min	player_Eric-Eichmann	player_A/90min
player_Manny-Lagos_Club	player_Manny-Lagos	player_Club
player_Manny-Lagos_POS	player_Manny-Lagos	player_POS
player_Manny-Lagos_GP	player_Manny-Lagos	player_GP
player_Manny-Lagos_GS	player_Manny-Lagos	player_GS
player_Manny-Lagos_A	player_Manny-Lagos	player_A
player_Manny-Lagos_GWA	player_Manny-Lagos	player_GWA
player_Manny-Lagos_HmA	player_Manny-Lagos	player_HmA
player_Manny-Lagos_RdA	player_Manny-Lagos	player_RdA
player_Manny-Lagos_A/90min	player_Manny-Lagos	player_A/90min
player_Victor-Mella_Club	player_Victor-Mella	player_Club
player_Victor-Mella_POS	player_Victor-Mella	player_POS
player_Victor-Mella_GP	player_Victor-Mella	player_GP
player_Victor-Mella_GS	player_Victor-Mella	player_GS
player_Victor-Mella_A	player_Victor-Mella	player_A
player_Victor-Mella_GWA	player_Victor-Mella	player_GWA
player_Victor-Mella_HmA	player_Victor-Mella	player_HmA
player_Victor-Mella_RdA	player_Victor-Mella	player_RdA
player_Victor-Mella_A/90min	player_Victor-Mella	player_A/90min
player_Antony-De-Avila_Club	player_Antony-De-Avila	player_Club
player_Antony-De-Avila_POS	player_Antony-De-Avila	player_POS
player_Antony-De-Avila_GP	player_Antony-De-Avila	player_GP
player_Antony-De-Avila_GS	player_Antony-De-Avila	player_GS
player_Antony-De-Avila_A	player_Antony-De-Avila	player_A
player_Antony-De-Avila_GWA	player_Antony-De-Avila	player_GWA
player_Antony-De-Avila_HmA	player_Antony-De-Avila	player_HmA
player_Antony-De-Avila_RdA	player_Antony-De-Avila	player_RdA
player_Antony-De-Avila_A/90min	player_Antony-De-Avila	player_A/90min
player_Richard-Sharpe_Club	player_Richard-Sharpe	player_Club
player_Richard-Sharpe_POS	player_Richard-Sharpe	player_POS
player_Richard-Sharpe_GP	player_Richard-Sharpe	player_GP
player_Richard-Sharpe_GS	player_Richard-Sharpe	player_GS
player_Richard-Sharpe_A	player_Richard-Sharpe	player_A
player_Richard-Sharpe_GWA	player_Richard-Sharpe	player_GWA
player_Richard-Sharpe_HmA	player_Richard-Sharpe	player_HmA
player_Richard-Sharpe_RdA	player_Richard-Sharpe	player_RdA
player_Richard-Sharpe_A/90min	player_Richard-Sharpe	player_A/90min
player_John-Maessner_Club	player_John-Maessner	player_Club
player_John-Maessner_POS	player_John-Maessner	player_POS
player_John-Maessner_GP	player_John-Maessner	player_GP
player_John-Maessner_GS	player_John-Maessner	player_GS
player_John-Maessner_A	player_John-Maessner	player_A
player_John-Maessner_GWA	player_John-Maessner	player_GWA
player_John-Maessner_HmA	player_John-Maessner	player_HmA
player_John-Maessner_RdA	player_John-Maessner	player_RdA
player_John-Maessner_A/90min	player_John-Maessner	player_A/90min
player_Frankie-Hejduk_Club	player_Frankie-Hejduk	player_Club
player_Frankie-Hejduk_POS	player_Frankie-Hejduk	player_POS
player_Frankie-Hejduk_GP	player_Frankie-Hejduk	player_GP
player_Frankie-Hejduk_GS	player_Frankie-Hejduk	player_GS
player_Frankie-Hejduk_A	player_Frankie-Hejduk	player_A
player_Frankie-Hejduk_GWA	player_Frankie-Hejduk	player_GWA
player_Frankie-Hejduk_HmA	player_Frankie-Hejduk	player_HmA
player_Frankie-Hejduk_RdA	player_Frankie-Hejduk	player_RdA
player_Frankie-Hejduk_A/90min	player_Frankie-Hejduk	player_A/90min
player_Imad-Baba_Club	player_Imad-Baba	player_Club
player_Imad-Baba_POS	player_Imad-Baba	player_POS
player_Imad-Baba_GP	player_Imad-Baba	player_GP
player_Imad-Baba_GS	player_Imad-Baba	player_GS
player_Imad-Baba_A	player_Imad-Baba	player_A
player_Imad-Baba_GWA	player_Imad-Baba	player_GWA
player_Imad-Baba_HmA	player_Imad-Baba	player_HmA
player_Imad-Baba_RdA	player_Imad-Baba	player_RdA
player_Imad-Baba_A/90min	player_Imad-Baba	player_A/90min
player_Washington-Rodriguez_Club	player_Washington-Rodriguez	player_Club
player_Washington-Rodriguez_POS	player_Washington-Rodriguez	player_POS
player_Washington-Rodriguez_GP	player_Washington-Rodriguez	player_GP
player_Washington-Rodriguez_GS	player_Washington-Rodriguez	player_GS
player_Washington-Rodriguez_A	player_Washington-Rodriguez	player_A
player_Washington-Rodriguez_GWA	player_Washington-Rodriguez	player_GWA
player_Washington-Rodriguez_HmA	player_Washington-Rodriguez	player_HmA
player_Washington-Rodriguez_RdA	player_Washington-Rodriguez	player_RdA
player_Washington-Rodriguez_A/90min	player_Washington-Rodriguez	player_A/90min
player_Arash-Noamouz_Club	player_Arash-Noamouz	player_Club
player_Arash-Noamouz_POS	player_Arash-Noamouz	player_POS
player_Arash-Noamouz_GP	player_Arash-Noamouz	player_GP
player_Arash-Noamouz_GS	player_Arash-Noamouz	player_GS
player_Arash-Noamouz_A	player_Arash-Noamouz	player_A
player_Arash-Noamouz_GWA	player_Arash-Noamouz	player_GWA
player_Arash-Noamouz_HmA	player_Arash-Noamouz	player_HmA
player_Arash-Noamouz_RdA	player_Arash-Noamouz	player_RdA
player_Arash-Noamouz_A/90min	player_Arash-Noamouz	player_A/90min
player_Jose-Vasquez_Club	player_Jose-Vasquez	player_Club
player_Jose-Vasquez_POS	player_Jose-Vasquez	player_POS
player_Jose-Vasquez_GP	player_Jose-Vasquez	player_GP
player_Jose-Vasquez_GS	player_Jose-Vasquez	player_GS
player_Jose-Vasquez_A	player_Jose-Vasquez	player_A
player_Jose-Vasquez_GWA	player_Jose-Vasquez	player_GWA
player_Jose-Vasquez_HmA	player_Jose-Vasquez	player_HmA
player_Jose-Vasquez_RdA	player_Jose-Vasquez	player_RdA
player_Jose-Vasquez_A/90min	player_Jose-Vasquez	player_A/90min
player_A.J.-Wood_Club	player_A.J.-Wood	player_Club
player_A.J.-Wood_POS	player_A.J.-Wood	player_POS
player_A.J.-Wood_GP	player_A.J.-Wood	player_GP
player_A.J.-Wood_GS	player_A.J.-Wood	player_GS
player_A.J.-Wood_A	player_A.J.-Wood	player_A
player_A.J.-Wood_GWA	player_A.J.-Wood	player_GWA
player_A.J.-Wood_HmA	player_A.J.-Wood	player_HmA
player_A.J.-Wood_RdA	player_A.J.-Wood	player_RdA
player_A.J.-Wood_A/90min	player_A.J.-Wood	player_A/90min
player_Brian-Maisonneuve_Club	player_Brian-Maisonneuve	player_Club
player_Brian-Maisonneuve_POS	player_Brian-Maisonneuve	player_POS
player_Brian-Maisonneuve_GP	player_Brian-Maisonneuve	player_GP
player_Brian-Maisonneuve_GS	player_Brian-Maisonneuve	player_GS
player_Brian-Maisonneuve_A	player_Brian-Maisonneuve	player_A
player_Brian-Maisonneuve_GWA	player_Brian-Maisonneuve	player_GWA
player_Brian-Maisonneuve_HmA	player_Brian-Maisonneuve	player_HmA
player_Brian-Maisonneuve_RdA	player_Brian-Maisonneuve	player_RdA
player_Brian-Maisonneuve_A/90min	player_Brian-Maisonneuve	player_A/90min
player_Todd-Yeagley_Club	player_Todd-Yeagley	player_Club
player_Todd-Yeagley_POS	player_Todd-Yeagley	player_POS
player_Todd-Yeagley_GP	player_Todd-Yeagley	player_GP
player_Todd-Yeagley_GS	player_Todd-Yeagley	player_GS
player_Todd-Yeagley_A	player_Todd-Yeagley	player_A
player_Todd-Yeagley_GWA	player_Todd-Yeagley	player_GWA
player_Todd-Yeagley_HmA	player_Todd-Yeagley	player_HmA
player_Todd-Yeagley_RdA	player_Todd-Yeagley	player_RdA
player_Todd-Yeagley_A/90min	player_Todd-Yeagley	player_A/90min
player_Ricardo-Iribarren_Club	player_Ricardo-Iribarren	player_Club
player_Ricardo-Iribarren_POS	player_Ricardo-Iribarren	player_POS
player_Ricardo-Iribarren_GP	player_Ricardo-Iribarren	player_GP
player_Ricardo-Iribarren_GS	player_Ricardo-Iribarren	player_GS
player_Ricardo-Iribarren_A	player_Ricardo-Iribarren	player_A
player_Ricardo-Iribarren_GWA	player_Ricardo-Iribarren	player_GWA
player_Ricardo-Iribarren_HmA	player_Ricardo-Iribarren	player_HmA
player_Ricardo-Iribarren_RdA	player_Ricardo-Iribarren	player_RdA
player_Ricardo-Iribarren_A/90min	player_Ricardo-Iribarren	player_A/90min
player_Marcelo-Carrera_Club	player_Marcelo-Carrera	player_Club
player_Marcelo-Carrera_POS	player_Marcelo-Carrera	player_POS
player_Marcelo-Carrera_GP	player_Marcelo-Carrera	player_GP
player_Marcelo-Carrera_GS	player_Marcelo-Carrera	player_GS
player_Marcelo-Carrera_A	player_Marcelo-Carrera	player_A
player_Marcelo-Carrera_GWA	player_Marcelo-Carrera	player_GWA
player_Marcelo-Carrera_HmA	player_Marcelo-Carrera	player_HmA
player_Marcelo-Carrera_RdA	player_Marcelo-Carrera	player_RdA
player_Marcelo-Carrera_A/90min	player_Marcelo-Carrera	player_A/90min
player_John-Kerr_Club	player_John-Kerr	player_Club
player_John-Kerr_POS	player_John-Kerr	player_POS
player_John-Kerr_GP	player_John-Kerr	player_GP
player_John-Kerr_GS	player_John-Kerr	player_GS
player_John-Kerr_A	player_John-Kerr	player_A
player_John-Kerr_GWA	player_John-Kerr	player_GWA
player_John-Kerr_HmA	player_John-Kerr	player_HmA
player_John-Kerr_RdA	player_John-Kerr	player_RdA
player_John-Kerr_A/90min	player_John-Kerr	player_A/90min
player_Goran-Hunjak_Club	player_Goran-Hunjak	player_Club
player_Goran-Hunjak_POS	player_Goran-Hunjak	player_POS
player_Goran-Hunjak_GP	player_Goran-Hunjak	player_GP
player_Goran-Hunjak_GS	player_Goran-Hunjak	player_GS
player_Goran-Hunjak_A	player_Goran-Hunjak	player_A
player_Goran-Hunjak_GWA	player_Goran-Hunjak	player_GWA
player_Goran-Hunjak_HmA	player_Goran-Hunjak	player_HmA
player_Goran-Hunjak_RdA	player_Goran-Hunjak	player_RdA
player_Goran-Hunjak_A/90min	player_Goran-Hunjak	player_A/90min
player_Marcelo-Balboa_Club	player_Marcelo-Balboa	player_Club
player_Marcelo-Balboa_POS	player_Marcelo-Balboa	player_POS
player_Marcelo-Balboa_GP	player_Marcelo-Balboa	player_GP
player_Marcelo-Balboa_GS	player_Marcelo-Balboa	player_GS
player_Marcelo-Balboa_A	player_Marcelo-Balboa	player_A
player_Marcelo-Balboa_GWA	player_Marcelo-Balboa	player_GWA
player_Marcelo-Balboa_HmA	player_Marcelo-Balboa	player_HmA
player_Marcelo-Balboa_RdA	player_Marcelo-Balboa	player_RdA
player_Marcelo-Balboa_A/90min	player_Marcelo-Balboa	player_A/90min
player_Kevin-Wylie_Club	player_Kevin-Wylie	player_Club
player_Kevin-Wylie_POS	player_Kevin-Wylie	player_POS
player_Kevin-Wylie_GP	player_Kevin-Wylie	player_GP
player_Kevin-Wylie_GS	player_Kevin-Wylie	player_GS
player_Kevin-Wylie_A	player_Kevin-Wylie	player_A
player_Kevin-Wylie_GWA	player_Kevin-Wylie	player_GWA
player_Kevin-Wylie_HmA	player_Kevin-Wylie	player_HmA
player_Kevin-Wylie_RdA	player_Kevin-Wylie	player_RdA
player_Kevin-Wylie_A/90min	player_Kevin-Wylie	player_A/90min
player_Paul-Caligiuri_Club	player_Paul-Caligiuri	player_Club
player_Paul-Caligiuri_POS	player_Paul-Caligiuri	player_POS
player_Paul-Caligiuri_GP	player_Paul-Caligiuri	player_GP
player_Paul-Caligiuri_GS	player_Paul-Caligiuri	player_GS
player_Paul-Caligiuri_A	player_Paul-Caligiuri	player_A
player_Paul-Caligiuri_GWA	player_Paul-Caligiuri	player_GWA
player_Paul-Caligiuri_HmA	player_Paul-Caligiuri	player_HmA
player_Paul-Caligiuri_RdA	player_Paul-Caligiuri	player_RdA
player_Paul-Caligiuri_A/90min	player_Paul-Caligiuri	player_A/90min
player_Doctor-Khumalo_Club	player_Doctor-Khumalo	player_Club
player_Doctor-Khumalo_POS	player_Doctor-Khumalo	player_POS
player_Doctor-Khumalo_GP	player_Doctor-Khumalo	player_GP
player_Doctor-Khumalo_GS	player_Doctor-Khumalo	player_GS
player_Doctor-Khumalo_A	player_Doctor-Khumalo	player_A
player_Doctor-Khumalo_GWA	player_Doctor-Khumalo	player_GWA
player_Doctor-Khumalo_HmA	player_Doctor-Khumalo	player_HmA
player_Doctor-Khumalo_RdA	player_Doctor-Khumalo	player_RdA
player_Doctor-Khumalo_A/90min	player_Doctor-Khumalo	player_A/90min
player_Raul-Diaz-Arce_Club	player_Raul-Diaz-Arce	player_Club
player_Raul-Diaz-Arce_POS	player_Raul-Diaz-Arce	player_POS
player_Raul-Diaz-Arce_GP	player_Raul-Diaz-Arce	player_GP
player_Raul-Diaz-Arce_GS	player_Raul-Diaz-Arce	player_GS
player_Raul-Diaz-Arce_A	player_Raul-Diaz-Arce	player_A
player_Raul-Diaz-Arce_GWA	player_Raul-Diaz-Arce	player_GWA
player_Raul-Diaz-Arce_HmA	player_Raul-Diaz-Arce	player_HmA
player_Raul-Diaz-Arce_RdA	player_Raul-Diaz-Arce	player_RdA
player_Raul-Diaz-Arce_A/90min	player_Raul-Diaz-Arce	player_A/90min
player_Mark-Semioli_Club	player_Mark-Semioli	player_Club
player_Mark-Semioli_POS	player_Mark-Semioli	player_POS
player_Mark-Semioli_GP	player_Mark-Semioli	player_GP
player_Mark-Semioli_GS	player_Mark-Semioli	player_GS
player_Mark-Semioli_A	player_Mark-Semioli	player_A
player_Mark-Semioli_GWA	player_Mark-Semioli	player_GWA
player_Mark-Semioli_HmA	player_Mark-Semioli	player_HmA
player_Mark-Semioli_RdA	player_Mark-Semioli	player_RdA
player_Mark-Semioli_A/90min	player_Mark-Semioli	player_A/90min
player_Michael-Emenalo_Club	player_Michael-Emenalo	player_Club
player_Michael-Emenalo_POS	player_Michael-Emenalo	player_POS
player_Michael-Emenalo_GP	player_Michael-Emenalo	player_GP
player_Michael-Emenalo_GS	player_Michael-Emenalo	player_GS
player_Michael-Emenalo_A	player_Michael-Emenalo	player_A
player_Michael-Emenalo_GWA	player_Michael-Emenalo	player_GWA
player_Michael-Emenalo_HmA	player_Michael-Emenalo	player_HmA
player_Michael-Emenalo_RdA	player_Michael-Emenalo	player_RdA
player_Michael-Emenalo_A/90min	player_Michael-Emenalo	player_A/90min
player_Mark-Santel_Club	player_Mark-Santel	player_Club
player_Mark-Santel_POS	player_Mark-Santel	player_POS
player_Mark-Santel_GP	player_Mark-Santel	player_GP
player_Mark-Santel_GS	player_Mark-Santel	player_GS
player_Mark-Santel_A	player_Mark-Santel	player_A
player_Mark-Santel_GWA	player_Mark-Santel	player_GWA
player_Mark-Santel_HmA	player_Mark-Santel	player_HmA
player_Mark-Santel_RdA	player_Mark-Santel	player_RdA
player_Mark-Santel_A/90min	player_Mark-Santel	player_A/90min
player_Steve-Ralston_Club	player_Steve-Ralston	player_Club
player_Steve-Ralston_POS	player_Steve-Ralston	player_POS
player_Steve-Ralston_GP	player_Steve-Ralston	player_GP
player_Steve-Ralston_GS	player_Steve-Ralston	player_GS
player_Steve-Ralston_A	player_Steve-Ralston	player_A
player_Steve-Ralston_GWA	player_Steve-Ralston	player_GWA
player_Steve-Ralston_HmA	player_Steve-Ralston	player_HmA
player_Steve-Ralston_RdA	player_Steve-Ralston	player_RdA
player_Steve-Ralston_A/90min	player_Steve-Ralston	player_A/90min
player_Steve-Trittschuh_Club	player_Steve-Trittschuh	player_Club
player_Steve-Trittschuh_POS	player_Steve-Trittschuh	player_POS
player_Steve-Trittschuh_GP	player_Steve-Trittschuh	player_GP
player_Steve-Trittschuh_GS	player_Steve-Trittschuh	player_GS
player_Steve-Trittschuh_A	player_Steve-Trittschuh	player_A
player_Steve-Trittschuh_GWA	player_Steve-Trittschuh	player_GWA
player_Steve-Trittschuh_HmA	player_Steve-Trittschuh	player_HmA
player_Steve-Trittschuh_RdA	player_Steve-Trittschuh	player_RdA
player_Steve-Trittschuh_A/90min	player_Steve-Trittschuh	player_A/90min
player_Obi-Monome_Club	player_Obi-Monome	player_Club
player_Obi-Monome_POS	player_Obi-Monome	player_POS
player_Obi-Monome_GP	player_Obi-Monome	player_GP
player_Obi-Monome_GS	player_Obi-Monome	player_GS
player_Obi-Monome_A	player_Obi-Monome	player_A
player_Obi-Monome_GWA	player_Obi-Monome	player_GWA
player_Obi-Monome_HmA	player_Obi-Monome	player_HmA
player_Obi-Monome_RdA	player_Obi-Monome	player_RdA
player_Obi-Monome_A/90min	player_Obi-Monome	player_A/90min
player_Andrew-Shue_Club	player_Andrew-Shue	player_Club
player_Andrew-Shue_POS	player_Andrew-Shue	player_POS
player_Andrew-Shue_GP	player_Andrew-Shue	player_GP
player_Andrew-Shue_GS	player_Andrew-Shue	player_GS
player_Andrew-Shue_A	player_Andrew-Shue	player_A
player_Andrew-Shue_GWA	player_Andrew-Shue	player_GWA
player_Andrew-Shue_HmA	player_Andrew-Shue	player_HmA
player_Andrew-Shue_RdA	player_Andrew-Shue	player_RdA
player_Andrew-Shue_A/90min	player_Andrew-Shue	player_A/90min
player_Todd-Miller_Club	player_Todd-Miller	player_Club
player_Todd-Miller_POS	player_Todd-Miller	player_POS
player_Todd-Miller_GP	player_Todd-Miller	player_GP
player_Todd-Miller_GS	player_Todd-Miller	player_GS
player_Todd-Miller_A	player_Todd-Miller	player_A
player_Todd-Miller_GWA	player_Todd-Miller	player_GWA
player_Todd-Miller_HmA	player_Todd-Miller	player_HmA
player_Todd-Miller_RdA	player_Todd-Miller	player_RdA
player_Todd-Miller_A/90min	player_Todd-Miller	player_A/90min
player_Petter-Villegas_Club	player_Petter-Villegas	player_Club
player_Petter-Villegas_POS	player_Petter-Villegas	player_POS
player_Petter-Villegas_GP	player_Petter-Villegas	player_GP
player_Petter-Villegas_GS	player_Petter-Villegas	player_GS
player_Petter-Villegas_A	player_Petter-Villegas	player_A
player_Petter-Villegas_GWA	player_Petter-Villegas	player_GWA
player_Petter-Villegas_HmA	player_Petter-Villegas	player_HmA
player_Petter-Villegas_RdA	player_Petter-Villegas	player_RdA
player_Petter-Villegas_A/90min	player_Petter-Villegas	player_A/90min
